,user,numlogonDay,numlogonNight,numlogoffDay,numlogoffNight,numPClogonDay,numPClogonNight,numPClogoffDay,numPClogoffNight,onoffNotsameDay,onoffNotsameNight
0,AAB0162,0,355,0,356,0,1,0,1,0,1
1,AAB0398,0,356,356,0,0,1,1,0,356,356
2,AAC0610,278,387,193,194,1,1,1,1,85,193
3,AAC0668,0,356,190,166,0,1,1,1,190,190
4,AAC3270,0,356,356,0,0,1,1,0,356,356
5,AAD2188,0,356,356,0,0,1,1,0,356,356
6,AAD3030,0,356,356,0,0,1,1,0,356,356
7,AAF0819,302,363,25,362,25,8,25,7,277,1
8,AAF3937,0,356,193,163,0,1,1,1,193,193
9,AAG1447,197,159,0,356,1,1,0,1,197,197
10,AAG3799,1,354,0,356,1,1,0,1,1,2
11,AAH0721,0,356,0,356,0,1,0,1,0,0
12,AAM0138,0,356,199,157,0,1,1,1,199,199
13,AAM0729,0,356,0,356,0,1,0,1,0,0
14,AAP0352,17,360,375,2,17,5,20,2,358,358
15,AAP1919,80,373,442,11,75,18,79,11,362,362
16,AAP1942,275,355,356,0,1,1,1,0,81,355
17,AAR0641,356,0,0,356,1,0,0,1,356,356
18,AAS0144,0,356,0,356,0,1,0,1,0,0
19,AAS2987,0,356,356,0,0,1,1,0,356,356
20,AAS3428,321,530,31,470,34,29,31,31,290,60
21,AAT2913,0,288,162,126,0,1,1,1,162,162
22,AAV3669,0,356,0,356,0,1,0,1,0,0
23,AAW0894,347,375,63,374,59,8,59,7,284,1
24,ABB0167,148,0,0,148,1,0,0,1,148,148
25,ABB0300,208,210,8,410,9,27,8,27,200,200
26,ABC3523,0,356,356,0,0,1,1,0,356,356
27,ABD3426,311,631,58,511,25,8,27,6,253,120
28,ABE2352,0,356,0,356,0,1,0,1,0,0
29,ABG2353,0,356,0,356,0,1,0,1,0,0
30,ABG3605,0,356,356,0,0,1,1,0,356,356
31,ABH0349,329,363,51,363,50,8,50,8,278,0
32,ABH1181,0,355,0,356,0,1,0,1,0,1
33,ABH2671,0,356,356,0,0,1,1,0,356,356
34,ABJ0281,0,104,0,104,0,1,0,1,0,0
35,ABK0481,0,34,34,0,0,1,1,0,34,34
36,ABK3081,332,551,38,513,38,15,36,17,294,38
37,ABL0870,0,356,356,0,0,1,1,0,356,356
38,ABM3203,5,458,364,100,5,22,6,22,359,358
39,ABM3641,21,656,20,657,21,48,20,49,1,1
40,ABM3687,215,249,246,48,61,16,64,13,31,201
41,ABM3772,277,426,0,426,1,1,0,1,277,0
42,ABM3776,0,356,0,356,0,1,0,1,0,0
43,ABO1173,278,434,0,434,1,1,0,1,278,0
44,ABP2003,0,356,0,356,0,1,0,1,0,0
45,ABP2917,276,469,193,230,1,1,1,1,83,239
46,ABR0397,364,387,447,23,74,29,80,22,83,364
47,ABS0677,292,357,199,173,16,2,16,2,93,184
48,ABW0501,0,356,0,356,0,1,0,1,0,0
49,ACA0360,0,356,0,356,0,1,0,1,0,0
50,ACA3252,0,356,356,0,0,1,1,0,356,356
51,ACB0701,296,424,367,46,1,1,1,1,71,378
52,ACB3123,329,413,420,51,58,19,61,15,91,362
53,ACC2773,0,356,356,0,0,1,1,0,356,356
54,ACF1806,89,118,118,0,1,1,1,0,29,118
55,ACG0312,97,386,464,19,87,30,96,19,367,367
56,ACG3819,314,497,15,457,16,7,15,7,299,40
57,ACH0008,0,356,0,356,0,1,0,1,0,0
58,ACH1405,0,356,0,356,0,1,0,1,0,0
59,ACH1910,708,185,48,500,53,17,46,24,660,315
60,ACH2102,8,348,9,347,1,1,1,1,1,1
61,ACJ0014,0,356,356,0,0,1,1,0,356,356
62,ACL2943,483,161,0,356,1,1,0,1,483,195
63,ACM0100,275,356,356,0,1,1,1,0,81,356
64,ACM2278,136,180,0,180,1,1,0,1,136,0
65,ACM3964,287,356,0,356,1,1,0,1,287,0
66,ACN2347,378,379,89,381,80,23,80,25,289,2
67,ACP2122,310,393,377,18,12,7,13,6,67,375
68,ACR0331,0,356,0,356,0,1,0,1,0,0
69,ACR0748,0,356,356,0,0,1,1,0,356,356
70,ACS0128,206,279,8,278,8,9,8,8,198,1
71,ACS1921,82,378,446,14,73,23,81,14,364,364
72,ACV1946,349,412,441,50,71,20,76,13,92,362
73,ACW0426,0,356,356,0,0,1,1,0,356,356
74,ACW0464,98,1320,95,1323,97,835,94,838,3,3
75,ACW1707,0,356,0,356,0,1,0,1,0,0
76,ADB0350,0,356,356,0,0,1,1,0,356,356
77,ADB1105,28,279,284,23,28,16,34,11,256,256
78,ADB3853,0,356,0,356,0,1,0,1,0,0
79,ADC1469,0,356,356,0,0,1,1,0,356,356
80,ADG1430,274,356,0,356,1,1,0,1,274,0
81,ADG1737,65,441,61,445,60,16,58,20,4,4
82,ADH0975,101,373,465,9,95,18,102,9,364,364
83,ADM0158,5,367,361,11,5,12,6,11,356,356
84,ADM0765,194,162,0,356,1,1,0,1,194,194
85,ADM0923,349,397,266,209,73,13,75,10,83,188
86,ADM1894,353,374,439,11,71,19,75,11,86,363
87,ADM2762,0,356,356,0,0,1,1,0,356,356
88,ADP1625,52,438,409,81,49,27,51,25,357,357
89,ADP3667,18,517,17,518,17,13,16,14,1,1
90,ADR1517,275,356,356,0,1,1,1,0,81,356
91,ADS0763,190,166,0,356,1,1,0,1,190,190
92,ADS2428,92,1317,269,1140,90,848,85,852,177,177
93,ADS2950,338,173,29,297,32,3,28,7,309,124
94,ADV1640,0,41,41,0,0,1,1,0,41,41
95,ADV2467,356,0,0,356,1,0,0,1,356,356
96,ADW2832,0,356,188,168,0,1,1,1,188,188
97,AEB1458,188,168,0,356,1,1,0,1,188,188
98,AEB3249,281,356,0,356,1,1,0,1,281,0
99,AEB3574,346,378,434,15,64,23,70,15,88,363
100,AED1421,47,406,39,414,42,12,38,15,8,8
101,AEF2019,0,356,0,356,0,1,0,1,0,0
102,AEG1121,0,312,0,312,0,1,0,1,0,0
103,AEH0187,235,340,168,169,1,1,1,1,67,171
104,AEH2020,283,356,0,356,1,1,0,1,283,0
105,AEK3566,85,395,453,27,76,40,87,27,368,368
106,AEM0554,336,729,46,615,47,43,44,44,290,114
107,AEP1930,282,356,356,0,1,1,1,0,74,356
108,AEW1442,0,356,0,356,0,1,0,1,0,0
109,AFB0904,375,363,112,357,90,8,90,7,263,6
110,AFB1626,0,356,356,0,0,1,1,0,356,356
111,AFB3228,277,443,0,442,1,1,0,1,277,1
112,AFF1492,11,371,367,15,11,16,12,15,356,356
113,AFH1757,0,356,183,173,0,1,1,1,183,183
114,AFK3800,0,356,0,356,0,1,0,1,0,0
115,AFP2247,0,356,356,0,0,1,1,0,356,356
116,AFP2709,283,607,358,135,1,1,1,1,75,472
117,AGB0057,292,376,364,20,9,21,9,20,72,356
118,AGB3303,0,356,0,356,0,1,0,1,0,0
119,AGC0445,0,356,0,356,0,1,0,1,0,0
120,AGE1244,0,356,0,356,0,1,0,1,0,0
121,AGF0742,289,467,376,100,15,22,15,22,87,367
122,AGF1810,236,312,0,312,1,1,0,1,236,0
123,AGF2302,0,314,314,0,0,1,1,0,314,314
124,AGG3958,0,356,0,356,0,1,0,1,0,0
125,AGL1301,272,356,195,161,1,1,1,1,77,195
126,AGL3519,283,356,192,164,1,1,1,1,91,192
127,AGM0133,356,0,0,356,1,0,0,1,356,356
128,AGM3372,0,356,0,356,0,1,0,1,0,0
129,AGM3504,0,356,0,356,0,1,0,1,0,0
130,AGS0063,355,0,0,356,1,0,0,1,355,356
131,AGS2462,356,0,0,356,1,0,0,1,356,356
132,AGW1590,369,431,462,67,88,24,98,15,93,364
133,AHB0648,298,367,217,171,21,12,23,10,81,196
134,AHC0232,22,334,0,356,1,1,0,1,22,22
135,AHC1994,325,454,48,450,47,19,46,19,277,4
136,AHC3277,0,356,0,356,0,1,0,1,0,0
137,AHD2457,0,356,356,0,0,1,1,0,356,356
138,AHG1408,0,356,0,356,0,1,0,1,0,0
139,AHG3997,0,356,27,329,0,1,1,1,27,27
140,AHH0495,272,356,0,356,1,1,0,1,272,0
141,AHH1966,0,355,0,356,0,1,0,1,0,1
142,AHK1988,0,356,0,356,0,1,0,1,0,0
143,AHM0959,125,356,478,3,104,10,109,3,353,353
144,AHP0154,0,356,199,157,0,1,1,1,199,199
145,AHS2348,0,356,0,356,0,1,0,1,0,0
146,AIA2005,0,229,0,229,0,1,0,1,0,0
147,AIB0553,284,356,0,356,1,1,0,1,284,0
148,AIB1567,0,356,0,356,0,1,0,1,0,0
149,AIB3416,383,370,134,338,94,15,95,12,249,32
150,AIC1071,0,356,0,356,0,1,0,1,0,0
151,AID2774,75,376,79,372,65,20,69,16,4,4
152,AIF1202,1,355,356,0,1,1,1,0,355,355
153,AIH2535,287,363,11,366,15,8,11,11,276,3
154,AIJ0383,281,356,188,168,1,1,1,1,93,188
155,AIJ3995,61,399,66,394,58,15,63,10,5,5
156,AIL2511,0,356,356,0,0,1,1,0,356,356
157,AIP1614,340,452,423,89,59,16,65,9,83,363
158,AIS1082,0,356,0,356,0,1,0,1,0,0
159,AIT1264,0,356,187,169,0,1,1,1,187,187
160,AIV3936,283,356,187,169,1,1,1,1,96,187
161,AIY3991,277,356,0,356,1,1,0,1,277,0
162,AJB1380,376,373,451,13,83,14,87,12,75,360
163,AJC0722,0,356,0,356,0,1,0,1,0,0
164,AJC3010,0,356,0,356,0,1,0,1,0,0
165,AJG0240,205,271,257,33,20,4,20,4,52,238
166,AJH0279,0,356,0,356,0,1,0,1,0,0
167,AJH2110,337,389,68,385,61,33,63,28,269,4
168,AJH3517,0,356,182,174,0,1,1,1,182,182
169,AJK0611,0,356,356,0,0,1,1,0,356,356
170,AJM0243,201,155,0,356,1,1,0,1,201,201
171,AJM0345,284,358,5,353,1,3,1,3,279,5
172,AJM2385,0,356,0,356,0,1,0,1,0,0
173,AJN1275,285,427,196,231,1,1,1,1,89,196
174,AJO2788,0,356,0,356,0,1,0,1,0,0
175,AJP1199,301,361,376,5,21,6,21,5,75,356
176,AJQ0809,287,356,0,356,1,1,0,1,287,0
177,AJS0616,0,356,356,0,0,1,1,0,356,356
178,AJS3021,363,594,438,146,65,56,71,50,75,448
179,AJS3899,9,347,0,356,1,1,0,1,9,9
180,AJV0176,0,299,173,126,0,1,1,1,173,173
181,AJW1246,0,356,0,356,0,1,0,1,0,0
182,AKB2312,11,510,377,144,11,8,14,6,366,366
183,AKB3530,46,60,60,0,1,1,1,0,14,60
184,AKC1929,0,356,356,0,0,1,1,0,356,356
185,AKC3739,0,356,0,356,0,1,0,1,0,0
186,AKD0272,342,398,70,394,59,28,64,24,272,4
187,AKG2702,295,355,375,1,18,4,20,1,80,354
188,AKH0454,296,574,12,482,12,3,11,3,284,92
189,AKH1534,61,359,60,361,56,5,55,6,1,2
190,AKI3229,0,356,0,356,0,1,0,1,0,0
191,AKK2125,5,431,364,72,5,18,6,18,359,359
192,AKL1305,390,430,307,229,97,19,100,15,83,201
193,AKL1605,280,357,358,1,3,2,3,1,78,356
194,AKP3573,0,246,246,0,0,1,1,0,246,246
195,AKS0298,0,356,356,0,0,1,1,0,356,356
196,AKS3496,43,72,2,64,3,4,2,4,41,8
197,AKS3705,0,356,356,0,0,1,1,0,356,356
198,AKW1679,0,356,0,356,0,1,0,1,0,0
199,ALB1254,0,301,0,302,0,1,0,1,0,1
200,ALB2395,0,356,0,356,0,1,0,1,0,0
201,ALB3649,373,436,81,422,73,37,72,35,292,14
202,ALC1060,98,1328,96,1330,90,866,87,869,2,2
203,ALD3508,0,356,188,168,0,1,1,1,188,188
204,ALH1494,0,356,356,0,0,1,1,0,356,356
205,ALH1872,0,356,356,0,0,1,1,0,356,356
206,ALH2916,0,356,192,164,0,1,1,1,192,192
207,ALL0289,67,355,52,370,50,14,49,15,15,15
208,ALN2046,0,356,0,356,0,1,0,1,0,0
209,ALP2955,188,168,0,356,1,1,0,1,188,188
210,ALS2596,0,356,0,356,0,1,0,1,0,0
211,ALS2669,0,356,356,0,0,1,1,0,356,356
212,ALS3440,276,413,75,333,1,1,1,1,201,80
213,ALT1354,0,356,356,0,0,1,1,0,356,356
214,AMA2808,274,615,0,543,1,1,0,1,274,72
215,AMB3100,378,557,306,282,87,46,93,42,72,275
216,AMB3208,0,356,356,0,0,1,1,0,356,356
217,AMD2728,0,356,0,356,0,1,0,1,0,0
218,AME0732,0,356,0,356,0,1,0,1,0,0
219,AME1361,0,356,0,356,0,1,0,1,0,0
220,AME1490,242,365,300,66,12,6,13,5,58,299
221,AMH1481,0,356,356,0,0,1,1,0,356,356
222,AMH3562,0,356,356,0,0,1,1,0,356,356
223,AMJ2374,281,356,356,0,1,1,1,0,75,356
224,AMJ3174,0,191,42,149,0,1,1,1,42,42
225,AMM0734,0,355,356,0,0,1,1,0,356,355
226,AMM3906,0,356,0,356,0,1,0,1,0,0
227,AMN0911,367,368,274,181,80,13,80,12,93,187
228,AMO0582,0,356,0,356,0,1,0,1,0,0
229,AMR0197,0,356,356,0,0,1,1,0,356,356
230,AMS0630,0,356,0,356,0,1,0,1,0,0
231,AMS0712,384,375,464,11,92,19,100,10,80,364
232,ANB0938,284,358,356,0,1,1,1,0,72,358
233,ANB2766,293,359,371,3,16,4,16,3,78,356
234,ANC1319,283,356,187,169,1,1,1,1,96,187
235,ANC1834,0,356,0,356,0,1,0,1,0,0
236,ANC1950,0,466,5,461,0,1,1,1,5,5
237,ANF3332,287,415,5,415,6,1,5,1,282,0
238,ANH2482,356,0,0,356,1,0,0,1,356,356
239,ANH3059,0,356,356,0,0,1,1,0,356,356
240,ANK0777,0,356,356,0,0,1,1,0,356,356
241,ANL3024,337,425,429,63,64,12,69,7,92,362
242,ANM0564,291,359,23,358,22,4,22,3,268,1
243,ANO2653,366,368,285,169,82,13,88,7,81,199
244,AOC0982,265,356,356,0,1,1,1,0,91,356
245,AOD2178,0,356,356,0,0,1,1,0,356,356
246,AOM1457,478,177,22,357,20,3,20,2,456,180
247,AOP1542,4,352,82,274,1,1,1,1,78,78
248,APA1788,341,471,65,469,60,31,61,29,276,2
249,APB1122,276,356,0,356,1,1,0,1,276,0
250,APB3823,0,494,0,494,0,1,0,1,0,0
251,APC3043,101,1273,92,1282,97,799,88,807,9,9
252,APD0381,0,356,187,169,0,1,1,1,187,187
253,APH2985,0,356,356,0,0,1,1,0,356,356
254,APM0190,274,356,0,356,1,1,0,1,274,0
255,APP1054,52,898,48,902,51,611,47,615,4,4
256,APP1996,0,356,0,356,0,1,0,1,0,0
257,APP2488,421,1,63,359,62,1,59,4,358,358
258,APP3678,333,382,59,382,57,26,55,27,274,0
259,APS1968,6,369,0,375,1,1,0,1,6,6
260,APS3553,1,355,3,353,1,1,1,1,2,2
261,APS3701,2,354,356,0,1,1,1,0,354,354
262,ARB0208,195,282,476,1,100,7,105,1,281,281
263,ARB2515,0,356,356,0,0,1,1,0,356,356
264,ARB3934,0,356,182,174,0,1,1,1,182,182
265,ARC1223,0,356,0,356,0,1,0,1,0,0
266,ARC1725,310,362,23,363,24,7,22,8,287,1
267,ARC2809,283,359,7,359,8,4,7,4,276,0
268,ARC3034,295,358,376,2,21,3,21,2,81,356
269,ARF0575,0,356,0,356,0,1,0,1,0,0
270,ARG0441,277,355,0,356,1,1,0,1,277,1
271,ARG3554,0,356,0,356,0,1,0,1,0,0
272,ARH1610,0,356,356,0,0,1,1,0,356,356
273,ARH2097,307,369,28,372,30,13,26,16,279,3
274,ARH2262,0,356,0,356,0,1,0,1,0,0
275,ARJ0912,0,356,178,178,0,1,1,1,178,178
276,ARK3198,295,488,366,74,7,6,7,6,71,414
277,ARL2672,0,356,356,0,0,1,1,0,356,356
278,ARM0076,0,356,356,0,0,1,1,0,356,356
279,ARM0771,0,356,356,0,0,1,1,0,356,356
280,ARP1144,282,356,356,0,1,1,1,0,74,356
281,ARS3506,0,356,194,162,0,1,1,1,194,194
282,ARV0704,279,355,356,0,1,1,1,0,77,355
283,ARW0818,16,490,14,492,16,10,14,12,2,2
284,ARW1507,0,356,356,0,0,1,1,0,356,356
285,ARZ3464,307,417,20,399,21,4,20,4,287,18
286,ASC0177,365,371,274,176,69,16,73,12,91,195
287,ASD0993,0,356,0,356,0,1,0,1,0,0
288,ASD3348,0,356,0,356,0,1,0,1,0,0
289,ASF1136,0,356,356,0,0,1,1,0,356,356
290,ASG0072,272,356,0,356,1,1,0,1,272,0
291,ASH0142,0,356,0,356,0,1,0,1,0,0
292,ASH1710,0,356,0,356,0,1,0,1,0,0
293,ASK0599,0,356,0,356,0,1,0,1,0,0
294,ASK2349,24,331,0,356,1,1,0,1,24,25
295,ASM3771,0,356,0,356,0,1,0,1,0,0
296,ASM3925,0,356,356,0,0,1,1,0,356,356
297,ASP2895,70,286,2,354,1,1,1,1,68,68
298,ASS0120,18,362,19,361,17,7,18,6,1,1
299,ASS0280,286,356,0,356,1,1,0,1,286,0
300,ASS2760,0,356,356,0,0,1,1,0,356,356
301,ASW1918,326,426,410,67,47,10,50,7,84,359
302,ATB1273,279,356,187,169,1,1,1,1,92,187
303,ATC0218,0,356,0,356,0,1,0,1,0,0
304,ATC1587,0,356,356,0,0,1,1,0,356,356
305,ATD0146,44,361,230,175,44,6,47,4,186,186
306,ATF3708,0,86,86,0,0,1,1,0,86,86
307,ATF3951,0,356,199,157,0,1,1,1,199,199
308,ATH0225,318,475,402,70,38,22,42,18,84,405
309,ATH0720,0,356,0,356,0,1,0,1,0,0
310,ATM1003,0,356,189,167,0,1,1,1,189,189
311,ATM1615,311,495,390,84,26,17,31,12,79,411
312,ATP2680,138,195,0,194,1,1,0,1,138,1
313,ATR1677,52,410,52,410,51,26,51,26,0,0
314,ATR2560,0,356,0,356,0,1,0,1,0,0
315,ATR3231,0,356,0,356,0,1,0,1,0,0
316,ATT0293,13,403,378,38,13,8,16,6,365,365
317,ATT1191,0,487,361,126,0,1,1,1,361,361
318,AUA0826,0,356,0,356,0,1,0,1,0,0
319,AUG2242,0,356,356,0,0,1,1,0,356,356
320,AUI2464,356,0,0,356,1,0,0,1,356,356
321,AUR1359,0,356,0,356,0,1,0,1,0,0
322,AVC2328,0,356,0,356,0,1,0,1,0,0
323,AVH0566,0,427,0,427,0,1,0,1,0,0
324,AVH2360,19,337,0,356,1,1,0,1,19,19
325,AVH3584,0,356,0,356,0,1,0,1,0,0
326,AVP3044,98,1301,95,1304,97,838,94,841,3,3
327,AVS2317,295,361,8,361,9,6,8,6,287,0
328,AVT0526,0,344,344,0,0,1,1,0,344,344
329,AVV2056,0,356,0,356,0,1,0,1,0,0
330,AWB2282,280,356,0,356,1,1,0,1,280,0
331,AWH2466,242,0,0,242,1,0,0,1,242,242
332,AWM2286,287,361,370,3,12,6,14,3,83,358
333,AWV0836,0,198,0,198,0,1,0,1,0,0
334,AWW0254,0,318,318,0,0,1,1,0,318,318
335,AXL0479,0,301,301,0,0,1,1,0,301,301
336,AXW3243,292,481,0,428,1,1,0,1,292,53
337,AYA3962,0,356,0,356,0,1,0,1,0,0
338,AYD2775,303,612,7,507,7,2,7,1,296,105
339,AYL1635,0,356,356,0,0,1,1,0,356,356
340,AYP3586,279,356,0,356,1,1,0,1,279,0
341,AYS0110,1,355,0,356,1,1,0,1,1,1
342,AYS1628,318,363,405,4,46,8,49,4,87,359
343,AZA1012,271,356,1,355,1,1,1,1,270,1
344,AZB1225,0,356,0,356,0,1,0,1,0,0
345,AZG2343,265,323,20,324,21,8,19,9,245,1
346,AZK0622,279,356,0,356,1,1,0,1,279,0
347,BAA2451,0,356,356,0,0,1,1,0,356,356
348,BAB0518,0,356,0,356,0,1,0,1,0,0
349,BAB0541,380,368,470,3,92,13,98,3,90,365
350,BAB1619,376,397,470,36,100,17,104,12,94,361
351,BAB2968,0,356,356,0,0,1,1,0,356,356
352,BAC2914,0,271,150,121,0,1,1,1,150,150
353,BAC3730,0,356,0,356,0,1,0,1,0,0
354,BAG2641,371,447,289,254,90,14,87,15,82,193
355,BAH1259,0,429,0,429,0,1,0,1,0,0
356,BAH3684,0,356,356,0,0,1,1,0,356,356
357,BAL2366,385,379,101,386,84,38,87,30,284,7
358,BAL3618,274,356,356,0,1,1,1,0,82,356
359,BAO2928,213,267,137,134,15,3,16,2,76,133
360,BAR3420,336,346,142,280,72,7,72,8,194,66
361,BAT3066,376,389,459,17,82,33,95,17,83,372
362,BAV0390,0,320,320,0,0,1,1,0,320,320
363,BAW0780,292,476,361,63,1,1,1,1,69,413
364,BAW1019,0,356,0,356,0,1,0,1,0,0
365,BBA1230,321,376,68,373,60,22,63,18,253,3
366,BBB3612,0,356,356,0,0,1,1,0,356,356
367,BBC3733,0,356,0,356,0,1,0,1,0,0
368,BBF2388,0,356,186,170,0,1,1,1,186,186
369,BBH1056,89,1341,82,1348,86,874,79,879,7,7
370,BBH2509,273,356,356,0,1,1,1,0,83,356
371,BBH3587,82,402,84,400,74,45,78,43,2,2
372,BBH3779,0,356,0,356,0,1,0,1,0,0
373,BBM1701,0,356,0,356,0,1,0,1,0,0
374,BBM2604,268,356,0,356,1,1,0,1,268,0
375,BBM3688,0,356,356,0,0,1,1,0,356,356
376,BBP1093,0,356,0,356,0,1,0,1,0,0
377,BBT0062,360,58,3,415,5,10,3,11,357,357
378,BBT1948,0,413,0,413,0,1,0,1,0,0
379,BBV3875,0,356,356,0,0,1,1,0,356,356
380,BBW0594,288,388,10,390,11,2,9,3,278,2
381,BCB0294,0,356,356,0,0,1,1,0,356,356
382,BCB0521,52,389,416,25,50,13,56,8,364,364
383,BCB0909,278,356,187,169,1,1,1,1,91,187
384,BCB2072,274,356,0,356,1,1,0,1,274,0
385,BCB2676,0,356,356,0,0,1,1,0,356,356
386,BCC0456,0,356,0,356,0,1,0,1,0,0
387,BCC2536,90,144,20,125,22,12,20,13,70,19
388,BCG1029,0,356,0,356,0,1,0,1,0,0
389,BCH1138,0,356,356,0,0,1,1,0,356,356
390,BCH1656,0,356,0,356,0,1,0,1,0,0
391,BCH3651,0,356,0,356,0,1,0,1,0,0
392,BCL2082,0,356,202,154,0,1,1,1,202,202
393,BCM3794,0,488,0,488,0,1,0,1,0,0
394,BCO0877,0,356,0,356,0,1,0,1,0,0
395,BCO2338,0,356,67,289,0,1,1,1,67,67
396,BCS1604,313,406,386,49,28,15,30,13,73,357
397,BCS2912,276,356,189,167,1,1,1,1,87,189
398,BCW3480,0,356,0,356,0,1,0,1,0,0
399,BCZ1345,0,305,305,0,0,1,1,0,305,305
400,BDA1906,69,0,0,69,1,0,0,1,69,69
401,BDB2163,294,457,366,55,1,1,1,1,72,402
402,BDH0472,356,0,0,356,1,0,0,1,356,356
403,BDJ3001,298,365,377,4,20,7,22,4,79,361
404,BDJ3326,270,356,0,356,1,1,0,1,270,0
405,BDK0854,0,356,356,0,0,1,1,0,356,356
406,BDL1065,0,356,0,356,0,1,0,1,0,0
407,BDM3662,272,356,0,356,1,1,0,1,272,0
408,BDP0031,374,388,89,384,73,32,76,28,285,4
409,BDP3912,0,356,356,0,0,1,1,0,356,356
410,BDR0510,339,618,70,533,65,37,67,35,269,85
411,BDU0497,0,356,0,356,0,1,0,1,0,0
412,BDV2474,632,0,0,356,1,0,0,1,632,356
413,BDW1459,182,174,0,356,1,1,0,1,182,182
414,BEA0311,0,356,356,0,0,1,1,0,356,356
415,BEB1022,0,356,356,0,0,1,1,0,356,356
416,BEG3521,355,390,445,24,73,32,79,24,90,366
417,BEH0103,416,468,388,135,29,10,30,8,28,333
418,BEH2307,298,359,372,1,15,4,17,1,74,358
419,BEH2967,265,356,356,0,1,1,1,0,91,356
420,BEW1426,1,355,0,356,1,1,0,1,1,1
421,BFD1111,0,356,0,356,0,1,0,1,0,0
422,BFR3250,364,394,81,396,74,38,73,39,283,2
423,BGA0892,0,355,0,356,0,1,0,1,0,1
424,BGA2301,281,356,356,0,1,1,1,0,75,356
425,BGB3045,112,1336,106,1342,109,844,103,847,6,6
426,BGH2610,0,238,0,238,0,1,0,1,0,0
427,BGH2861,0,356,193,163,0,1,1,1,193,193
428,BGK0603,0,356,196,160,0,1,1,1,196,196
429,BGM1226,9,377,6,380,9,22,6,25,3,3
430,BGM2545,279,356,0,356,1,1,0,1,279,0
431,BGN3820,281,356,0,356,1,1,0,1,281,0
432,BGR1991,0,356,0,356,0,1,0,1,0,0
433,BGS0751,0,356,356,0,0,1,1,0,356,356
434,BGW1739,12,356,11,357,12,1,11,2,1,1
435,BHB2598,0,142,0,142,0,1,0,1,0,0
436,BHC0492,0,356,0,356,0,1,0,1,0,0
437,BHC2049,0,356,0,356,0,1,0,1,0,0
438,BHC2344,0,356,0,356,0,1,0,1,0,0
439,BHD0598,279,356,0,356,1,1,0,1,279,0
440,BHD2088,288,438,19,419,21,16,19,17,269,19
441,BHE1709,383,382,97,384,85,27,84,29,286,2
442,BHG0258,0,273,0,273,0,1,0,1,0,0
443,BHG3238,0,356,0,356,0,1,0,1,0,0
444,BHK2196,0,356,356,0,0,1,1,0,356,356
445,BHM0430,0,356,180,176,0,1,1,1,180,180
446,BHN2290,0,356,356,0,0,1,1,0,356,356
447,BHS1917,356,0,0,356,1,0,0,1,356,356
448,BHW2476,356,0,0,356,1,0,0,1,356,356
449,BIG3946,0,350,185,165,0,1,1,1,185,185
450,BIT2790,279,356,0,356,1,1,0,1,279,0
451,BJA1137,0,356,356,0,0,1,1,0,356,356
452,BJC0366,281,356,0,356,1,1,0,1,281,0
453,BJC3423,274,356,0,356,1,1,0,1,274,0
454,BJE0351,213,287,282,3,1,1,1,1,69,284
455,BJF0511,0,354,0,354,0,1,0,1,0,0
456,BJG0662,0,356,187,169,0,1,1,1,187,187
457,BJH3294,0,356,0,356,0,1,0,1,0,0
458,BJH3402,184,172,0,356,1,1,0,1,184,184
459,BJM2491,0,356,0,356,0,1,0,1,0,0
460,BJM3236,0,220,0,220,0,1,0,1,0,0
461,BJP0186,0,356,189,167,0,1,1,1,189,189
462,BJR0774,0,356,356,0,0,1,1,0,356,356
463,BJR0940,0,356,356,0,0,1,1,0,356,356
464,BJS0053,0,356,356,0,0,1,1,0,356,356
465,BJS0744,0,221,221,0,0,1,1,0,221,221
466,BJV2631,293,361,200,179,19,6,22,3,93,182
467,BJW2134,0,356,356,0,0,1,1,0,356,356
468,BJW3558,0,356,356,0,0,1,1,0,356,356
469,BKA0175,0,356,185,171,0,1,1,1,185,185
470,BKB0853,283,356,356,0,1,1,1,0,73,356
471,BKC2698,290,358,369,1,13,3,14,1,79,357
472,BKC3473,0,356,188,168,0,1,1,1,188,188
473,BKF0427,278,356,356,0,1,1,1,0,78,356
474,BKF1545,335,612,83,482,45,32,48,28,252,130
475,BKF2204,293,364,16,363,16,9,16,8,277,1
476,BKM1155,325,300,0,356,1,1,0,1,325,56
477,BKM2643,0,355,187,169,0,1,1,1,187,186
478,BKM3410,183,173,0,356,1,1,0,1,183,183
479,BKM3611,335,373,416,14,54,17,57,13,81,359
480,BKR3146,0,356,197,159,0,1,1,1,197,197
481,BKR3302,0,226,0,226,0,1,0,1,0,0
482,BKS1860,0,356,356,0,0,1,1,0,356,356
483,BKS2069,0,356,0,356,0,1,0,1,0,0
484,BKW1032,0,356,0,356,0,1,0,1,0,0
485,BLB1876,351,461,433,68,67,30,70,28,82,393
486,BLD2227,289,366,369,8,12,3,14,1,80,358
487,BLH3602,0,355,356,0,0,1,1,0,356,355
488,BLL3585,289,364,8,364,9,9,8,9,281,0
489,BLL3910,0,396,360,36,0,1,1,1,360,360
490,BLN0230,22,513,19,516,21,18,18,21,3,3
491,BLS1973,339,315,15,361,17,5,15,6,324,46
492,BLS3327,0,356,0,356,0,1,0,1,0,0
493,BLY1039,0,356,0,356,0,1,0,1,0,0
494,BMA1411,0,356,0,356,0,1,0,1,0,0
495,BMB0007,0,356,0,356,0,1,0,1,0,0
496,BMC3061,274,356,356,0,1,1,1,0,82,356
497,BMC3636,341,764,55,642,50,54,51,53,286,122
498,BMF2337,0,356,0,356,0,1,0,1,0,0
499,BMH0457,0,74,0,74,0,1,0,1,0,0
500,BMH1069,32,387,19,400,20,1,19,1,13,13
501,BMM0462,377,1308,91,1315,97,839,89,844,286,7
502,BMM3328,279,356,0,356,1,1,0,1,279,0
503,BMN0178,48,70,29,42,2,2,3,1,19,28
504,BMN3207,5,509,358,156,1,1,1,1,353,353
505,BMR1662,0,356,0,356,0,1,0,1,0,0
506,BMS0925,300,425,208,242,24,5,26,3,92,183
507,BMV1886,0,356,356,0,0,1,1,0,356,356
508,BNB3370,0,356,0,356,0,1,0,1,0,0
509,BNC1497,0,356,356,0,0,1,1,0,356,356
510,BNC3178,13,343,64,292,1,1,1,1,51,51
511,BNF1110,303,509,14,442,13,11,14,9,289,67
512,BNH2692,333,402,72,398,65,42,65,41,261,4
513,BNH3516,314,360,234,163,34,5,34,5,80,197
514,BNK0087,0,356,0,356,0,1,0,1,0,0
515,BNL1652,0,356,2,354,0,1,1,1,2,2
516,BNR2527,0,356,356,0,0,1,1,0,356,356
517,BNR3128,0,23,23,0,0,1,1,0,23,23
518,BNS2384,0,356,0,356,0,1,0,1,0,0
519,BNS3233,1,379,1,379,1,24,1,24,0,0
520,BNS3594,5,351,356,0,1,1,1,0,351,351
521,BNT0663,0,356,190,166,0,1,1,1,190,190
522,BNW3985,387,374,111,369,93,19,98,14,276,5
523,BOH1751,0,356,193,163,0,1,1,1,193,193
524,BOJ2179,0,356,356,0,0,1,1,0,356,356
525,BON0968,0,356,356,0,0,1,1,0,356,356
526,BOR2387,406,164,48,522,49,34,46,34,358,358
527,BOV1609,0,416,359,57,0,1,1,1,359,359
528,BPD2437,181,1537,364,1354,171,1004,171,1003,183,183
529,BPL3202,21,368,377,12,20,7,22,5,356,356
530,BPM3694,297,408,374,51,18,2,19,1,77,357
531,BPN3051,89,1325,88,1326,88,858,87,858,1,1
532,BPR1678,80,110,0,110,1,1,0,1,80,0
533,BQK2024,369,382,104,368,83,27,83,25,265,14
534,BQV1308,282,356,175,181,1,1,1,1,107,175
535,BQW1904,356,0,0,356,1,0,0,1,356,356
536,BRB2143,0,356,356,0,0,1,1,0,356,356
537,BRC1811,292,418,0,418,1,1,0,1,292,0
538,BRC3949,0,356,185,171,0,1,1,1,185,185
539,BRD3314,0,356,0,356,0,1,0,1,0,0
540,BRG3113,0,355,356,0,0,1,1,0,356,355
541,BRG3267,0,433,356,77,0,1,1,1,356,356
542,BRH1107,0,356,356,0,0,1,1,0,356,356
543,BRH2866,0,74,37,37,0,1,1,1,37,37
544,BRJ2151,22,368,381,9,22,13,26,9,359,359
545,BRM0143,0,356,0,356,0,1,0,1,0,0
546,BRM0843,187,169,0,356,1,1,0,1,187,187
547,BRN3289,0,356,0,356,0,1,0,1,0,0
548,BRR2899,49,307,0,356,1,1,0,1,49,49
549,BRS0333,0,356,1,355,0,1,1,1,1,1
550,BRW0963,275,356,356,0,1,1,1,0,81,356
551,BRW3552,306,350,31,352,25,4,26,3,275,2
552,BSB3083,281,356,0,356,1,1,0,1,281,0
553,BSM2288,0,356,356,0,0,1,1,0,356,356
554,BSM2844,0,356,179,177,0,1,1,1,179,179
555,BSS2956,468,157,0,356,1,1,0,1,468,199
556,BSS3551,0,356,0,356,0,1,0,1,0,0
557,BSV1499,288,356,356,0,1,1,1,0,68,356
558,BTB0489,0,356,0,356,0,1,0,1,0,0
559,BTG3468,6,350,8,348,1,1,1,1,2,2
560,BTR2026,0,356,0,356,0,1,0,1,0,0
561,BTV0644,0,356,194,162,0,1,1,1,194,194
562,BUS1727,400,366,114,366,103,11,101,11,286,0
563,BUS2399,345,383,266,190,70,24,77,18,79,193
564,BUW2717,0,356,356,0,0,1,1,0,356,356
565,BVB1673,1,33,2,32,1,2,2,1,1,1
566,BVC0009,633,53,0,409,1,1,0,1,633,356
567,BVD3974,0,356,0,356,0,1,0,1,0,0
568,BVK1096,0,128,128,0,0,1,1,0,128,128
569,BWA2593,284,356,0,356,1,1,0,1,284,0
570,BWC2534,360,367,90,362,77,31,81,26,270,5
571,BWG3220,0,356,0,356,0,1,0,1,0,0
572,BWJ0136,363,80,0,443,1,1,0,1,363,363
573,BWK0172,0,356,0,356,0,1,0,1,0,0
574,BWM2339,326,370,46,369,45,14,43,14,280,1
575,BWW1159,298,344,0,356,1,1,0,1,298,12
576,BXG1340,348,369,433,9,66,14,69,9,85,360
577,BXG3763,0,356,0,356,0,1,0,1,0,0
578,BXK2091,274,356,0,356,1,1,0,1,274,0
579,BXN0660,0,356,196,160,0,1,1,1,196,196
580,BXR3536,0,356,356,0,0,1,1,0,356,356
581,BXT2678,311,366,393,6,31,12,36,6,82,360
582,BXW1804,76,100,99,0,1,1,1,0,23,100
583,BYC3970,0,356,0,356,0,1,0,1,0,0
584,BYF3784,352,363,76,363,68,11,72,8,276,0
585,BYL2133,0,356,356,0,0,1,1,0,356,356
586,BYS3626,281,412,363,28,1,1,1,1,82,384
587,BZB3532,0,431,360,71,0,1,1,1,360,360
588,BZC3956,191,241,129,112,1,1,1,1,62,129
589,BZH1158,265,356,0,356,1,1,0,1,265,0
590,BZS1344,0,356,356,0,0,1,1,0,356,356
591,CAB3121,0,356,356,0,0,1,1,0,356,356
592,CAC0147,0,356,192,164,0,1,1,1,192,192
593,CAC1777,100,1297,451,946,96,845,93,849,351,351
594,CAC3741,0,356,0,356,0,1,0,1,0,0
595,CAF1331,0,356,356,0,0,1,1,0,356,356
596,CAF3929,284,356,177,179,1,1,1,1,107,177
597,CAG0502,0,356,0,356,0,1,0,1,0,0
598,CAG0888,348,399,69,393,58,11,63,5,279,6
599,CAG1644,0,356,0,356,0,1,0,1,0,0
600,CAG2236,219,271,271,0,1,1,1,0,52,271
601,CAG2442,430,1333,342,1138,145,838,143,839,88,195
602,CAG3049,103,1352,96,1359,99,873,92,880,7,7
603,CAG3622,0,356,356,0,0,1,1,0,356,356
604,CAH1839,6,419,5,420,6,1,5,1,1,1
605,CAM0679,281,356,0,356,1,1,0,1,281,0
606,CAM1323,277,402,186,216,1,1,1,1,91,186
607,CAM2468,356,0,0,356,1,0,0,1,356,356
608,CAM3050,386,1358,95,1363,98,870,92,872,291,5
609,CAO3117,0,356,356,0,0,1,1,0,356,356
610,CAP1971,0,356,0,356,0,1,0,1,0,0
611,CAP2149,0,356,356,0,0,1,1,0,356,356
612,CAP2283,273,356,356,0,1,1,1,0,83,356
613,CAR0928,282,357,356,0,1,1,1,0,74,357
614,CAR0992,309,400,403,38,41,22,47,15,94,362
615,CAR2244,22,461,380,103,22,30,24,28,358,358
616,CAR2748,0,356,0,356,0,1,0,1,0,0
617,CAR2900,64,292,0,356,1,1,0,1,64,64
618,CAS0391,0,356,356,0,0,1,1,0,356,356
619,CAS1017,0,356,356,0,0,1,1,0,356,356
620,CAS1702,0,356,0,356,0,1,0,1,0,0
621,CAS3022,0,356,356,0,0,1,1,0,356,356
622,CAV1868,275,356,356,0,1,1,1,0,81,356
623,CBA1023,17,479,19,477,17,9,19,7,2,2
624,CBB2904,285,358,212,161,13,4,13,4,73,197
625,CBB3018,0,356,0,356,0,1,0,1,0,0
626,CBC0952,275,356,356,0,1,1,1,0,81,356
627,CBC3175,285,349,63,293,1,1,1,1,222,56
628,CBD0802,549,188,87,378,84,20,80,23,462,190
629,CBD3251,0,356,356,0,0,1,1,0,356,356
630,CBG1074,285,356,10,356,11,1,10,1,275,0
631,CBG1142,21,360,378,3,20,5,22,3,357,357
632,CBG2875,384,373,101,376,94,18,90,21,283,3
633,CBH0413,13,319,332,0,1,1,1,0,319,319
634,CBJ0683,0,256,0,256,0,1,0,1,0,0
635,CBJ2083,0,356,186,170,0,1,1,1,186,186
636,CBJ3719,0,356,0,356,0,1,0,1,0,0
637,CBL3631,358,392,84,391,76,37,77,34,274,1
638,CBM0060,0,356,356,0,0,1,1,0,356,356
639,CBM0410,295,387,370,31,14,1,14,1,75,356
640,CBM1814,12,344,0,356,1,1,0,1,12,12
641,CBM2858,343,367,261,167,58,11,62,7,82,200
642,CBR0121,301,365,18,367,20,10,17,12,283,2
643,CBR2229,0,356,356,0,0,1,1,0,356,356
644,CBS0951,0,223,199,24,0,1,1,1,199,199
645,CBW2427,91,1330,269,1152,86,861,81,865,178,178
646,CCB0547,286,356,0,356,1,1,0,1,286,0
647,CCB3055,410,1376,116,1377,115,865,113,866,294,1
648,CCB3173,7,349,59,297,1,1,1,1,52,52
649,CCB3943,0,356,185,171,0,1,1,1,185,185
650,CCC0491,277,356,0,356,1,1,0,1,277,0
651,CCD3168,0,191,0,191,0,1,0,1,0,0
652,CCE0745,0,356,356,0,0,1,1,0,356,356
653,CCF2298,0,356,356,0,0,1,1,0,356,356
654,CCF3529,365,390,451,27,84,25,90,19,86,363
655,CCG1025,494,163,18,360,16,6,16,5,476,197
656,CCG3254,0,356,356,0,0,1,1,0,356,356
657,CCH1508,0,356,356,0,0,1,1,0,356,356
658,CCH1724,0,356,0,356,0,1,0,1,0,0
659,CCH3489,0,356,0,356,0,1,0,1,0,0
660,CCL1770,189,1345,551,983,181,867,184,860,362,362
661,CCL3272,0,356,0,356,0,1,0,1,0,0
662,CCM2207,0,356,0,356,0,1,0,1,0,0
663,CCM3075,283,356,0,356,1,1,0,1,283,0
664,CCN2726,286,358,9,358,11,2,9,3,277,0
665,CCS3575,0,356,356,0,0,1,1,0,356,356
666,CCT0020,0,356,356,0,0,1,1,0,356,356
667,CCT2165,322,633,411,163,48,32,51,29,89,470
668,CCW2381,277,401,356,45,1,1,1,1,79,356
669,CCW3901,363,367,82,373,70,22,73,18,281,6
670,CDA2295,0,330,330,0,0,1,1,0,330,330
671,CDB2017,280,552,6,496,8,3,6,4,274,56
672,CDB2947,196,185,6,375,7,20,6,20,190,190
673,CDB3222,0,356,0,356,0,1,0,1,0,0
674,CDC3413,62,543,67,538,59,38,63,33,5,5
675,CDD0127,291,356,0,356,1,1,0,1,291,0
676,CDE1846,48,317,2,363,3,8,2,8,46,46
677,CDL0867,0,356,356,0,0,1,1,0,356,356
678,CDL2145,0,356,356,0,0,1,1,0,356,356
679,CDM0538,349,359,428,0,62,4,65,0,79,359
680,CDM1097,0,72,72,0,0,1,1,0,72,72
681,CDM2075,0,356,191,165,0,1,1,1,191,191
682,CDP0340,3,353,81,275,1,1,1,1,78,78
683,CDP2892,0,356,0,356,0,1,0,1,0,0
684,CDS1579,85,395,83,397,76,39,73,40,2,2
685,CDS2792,0,356,0,356,0,1,0,1,0,0
686,CDS3824,0,355,0,356,0,1,0,1,0,1
687,CDW0886,0,147,0,147,0,1,0,1,0,0
688,CDW0986,0,356,356,0,0,1,1,0,356,356
689,CDW2000,273,356,0,356,1,1,0,1,273,0
690,CDY3409,196,160,0,356,1,1,0,1,196,196
691,CEB3714,0,356,0,356,0,1,0,1,0,0
692,CEC1352,52,381,420,13,52,7,56,4,368,368
693,CED2356,0,252,0,252,0,1,0,1,0,0
694,CEM1852,0,356,0,356,0,1,0,1,0,0
695,CER0228,450,475,94,515,86,36,81,40,356,40
696,CET3786,298,361,1,378,3,15,1,16,297,17
697,CFL0156,304,514,375,94,18,14,20,12,71,420
698,CFP3418,280,356,3,353,1,1,1,1,277,3
699,CFR1166,0,168,0,168,0,1,0,1,0,0
700,CFR1523,0,356,356,0,0,1,1,0,356,356
701,CFS1611,282,356,356,0,1,1,1,0,74,356
702,CGB2215,0,356,0,356,0,1,0,1,0,0
703,CGB3928,0,356,193,163,0,1,1,1,193,193
704,CGC1132,0,356,356,0,0,1,1,0,356,356
705,CGG2688,0,356,0,356,0,1,0,1,0,0
706,CGG3388,201,365,0,566,1,1,0,1,201,201
707,CGM0035,281,356,0,356,1,1,0,1,281,0
708,CGM2036,290,338,356,0,1,1,1,0,66,338
709,CGM3124,18,23,23,0,1,1,1,0,5,23
710,CGT3148,0,356,182,174,0,1,1,1,182,182
711,CGW0692,286,621,368,144,6,11,7,10,82,477
712,CGW3093,0,356,181,175,0,1,1,1,181,181
713,CHA3190,294,465,379,63,20,11,20,11,85,402
714,CHB0996,0,356,0,356,0,1,0,1,0,0
715,CHB1062,94,1372,91,1375,92,885,89,887,3,3
716,CHB3396,182,174,0,356,1,1,0,1,182,182
717,CHB3647,0,356,0,356,0,1,0,1,0,0
718,CHC0252,344,685,415,214,46,32,50,28,71,471
719,CHF1005,23,384,210,197,22,5,25,3,187,187
720,CHH2272,278,356,0,356,1,1,0,1,278,0
721,CHH3583,0,356,0,356,0,1,0,1,0,0
722,CHL2644,0,356,188,168,0,1,1,1,188,188
723,CHL3430,0,356,16,340,0,1,1,1,16,16
724,CHM1561,0,471,0,472,0,1,0,1,0,1
725,CHM2081,0,356,182,174,0,1,1,1,182,182
726,CHS2323,292,431,28,414,13,8,13,8,264,17
727,CHU3211,22,457,382,97,22,28,25,25,360,360
728,CHV0509,0,356,0,356,0,1,0,1,0,0
729,CHW2893,4,352,0,356,1,1,0,1,4,4
730,CHY0083,0,356,0,356,0,1,0,1,0,0
731,CID3640,304,361,24,361,25,6,24,6,280,0
732,CID3774,3,353,0,356,1,1,0,1,3,3
733,CIG1277,0,356,189,167,0,1,1,1,189,189
734,CIG2684,0,356,0,356,0,1,0,1,0,0
735,CIG3191,5,385,361,29,5,30,6,29,356,356
736,CIG3459,0,356,0,356,0,1,0,1,0,0
737,CIH0995,353,385,445,20,76,30,85,20,92,365
738,CIJ3941,0,356,206,150,0,1,1,1,206,206
739,CIR1367,54,481,55,480,54,52,55,51,1,1
740,CIS3471,0,356,0,356,0,1,0,1,0,0
741,CIS3505,15,341,0,356,1,1,0,1,15,15
742,CIT0310,0,356,356,0,0,1,1,0,356,356
743,CIV0935,0,356,356,0,0,1,1,0,356,356
744,CIY1654,307,371,39,368,38,14,38,13,268,3
745,CJB3470,0,356,0,356,0,1,0,1,0,0
746,CJC1433,354,427,67,415,68,32,64,36,287,12
747,CJC2371,7,349,0,356,1,1,0,1,7,7
748,CJF1934,55,77,69,12,5,1,5,1,14,65
749,CJG3002,0,356,189,167,0,1,1,1,189,189
750,CJH0382,0,356,195,161,0,1,1,1,195,195
751,CJH2330,0,474,0,474,0,1,0,1,0,0
752,CJH2411,38,45,45,0,1,1,1,0,7,45
753,CJH2921,0,356,190,166,0,1,1,1,190,190
754,CJH3136,283,494,208,225,1,1,1,1,75,269
755,CJH3630,0,356,356,0,0,1,1,0,356,356
756,CJJ1491,0,356,356,0,0,1,1,0,356,356
757,CJM0273,23,525,24,524,22,19,23,18,1,1
758,CJM0584,0,45,0,45,0,1,0,1,0,0
759,CJM2961,195,161,0,356,1,1,0,1,195,195
760,CJM3315,303,502,11,447,12,7,11,7,292,55
761,CJM3543,398,522,112,465,98,35,98,34,286,57
762,CJS1932,0,356,356,0,0,1,1,0,356,356
763,CJS1986,356,0,0,356,1,0,0,1,356,356
764,CJT1106,0,356,356,0,0,1,1,0,356,356
765,CJW0376,282,356,190,166,1,1,1,1,92,190
766,CJW2087,0,356,198,158,0,1,1,1,198,198
767,CJY2951,184,172,0,356,1,1,0,1,184,184
768,CKB0169,0,356,181,175,0,1,1,1,181,181
769,CKB0596,354,449,76,448,70,26,70,25,278,1
770,CKB3645,310,359,19,358,20,3,19,3,291,1
771,CKB3745,273,356,0,356,1,1,0,1,273,0
772,CKC3072,0,356,0,356,0,1,0,1,0,0
773,CKC3767,0,356,0,356,0,1,0,1,0,0
774,CKD3861,0,94,0,94,0,1,0,1,0,0
775,CKG1972,22,334,0,356,1,1,0,1,22,22
776,CKG3838,0,356,0,356,0,1,0,1,0,0
777,CKH0705,4,379,360,23,4,24,5,23,356,356
778,CKH0799,0,355,0,356,0,1,0,1,0,1
779,CKH2230,0,356,356,0,0,1,1,0,356,356
780,CKH2797,0,355,0,356,0,1,0,1,0,1
781,CKL0697,290,362,368,4,11,7,13,4,78,358
782,CKL3556,2,377,358,21,2,22,3,21,356,356
783,CKM0405,0,356,0,356,0,1,0,1,0,0
784,CKM0508,0,104,0,104,0,1,0,1,0,0
785,CKP0265,0,356,0,356,0,1,0,1,0,0
786,CKP0659,217,284,149,135,1,1,1,1,68,149
787,CKP3600,177,222,222,0,1,1,1,0,45,222
788,CKR2586,121,114,0,130,1,1,0,1,121,16
789,CLA1285,0,356,182,174,0,1,1,1,182,182
790,CLC1272,0,356,179,177,0,1,1,1,179,179
791,CLD1641,0,356,356,0,0,1,1,0,356,356
792,CLE3098,0,356,187,169,0,1,1,1,187,187
793,CLG3616,0,356,356,0,0,1,1,0,356,356
794,CLH0733,30,326,0,356,1,1,0,1,30,30
795,CLM1874,0,356,356,0,0,1,1,0,356,356
796,CLM2776,306,420,19,396,20,8,19,8,287,24
797,CLR1239,43,189,42,190,41,8,40,9,1,1
798,CLR2407,93,398,48,443,49,30,47,31,45,45
799,CLS3806,0,356,0,356,0,1,0,1,0,0
800,CMA1475,0,356,356,0,0,1,1,0,356,356
801,CMA2616,356,0,0,356,1,0,0,1,356,356
802,CMB2034,0,356,356,0,0,1,1,0,356,356
803,CMB3499,1,355,0,356,1,1,0,1,1,1
804,CMC1642,272,356,356,0,1,1,1,0,84,356
805,CMD0613,8,489,365,132,8,9,9,9,357,357
806,CMH0776,0,308,308,0,0,1,1,0,308,308
807,CMH2342,351,416,74,417,71,21,70,21,277,1
808,CMH3077,0,356,0,356,0,1,0,1,0,0
809,CMM0764,567,371,73,489,74,27,70,30,494,118
810,CMM1068,345,365,73,363,65,10,66,8,272,2
811,CMM3674,0,356,0,356,0,1,0,1,0,0
812,CMM3702,281,356,356,0,1,1,1,0,75,356
813,CMM3753,378,380,100,378,92,25,91,23,278,2
814,CMO2396,276,378,356,26,1,1,1,1,80,352
815,CMP2946,446,151,26,322,29,5,26,7,420,171
816,CMR1470,388,378,469,14,95,23,102,14,81,364
817,CMS0010,0,356,194,162,0,1,1,1,194,194
818,CMS1900,5,358,363,0,5,3,8,0,358,358
819,CMS2897,65,426,67,424,60,14,62,12,2,2
820,CMT0267,182,174,0,356,1,1,0,1,182,182
821,CMW0437,378,376,304,173,90,20,94,11,74,203
822,CNB1131,51,379,410,20,50,6,54,3,359,359
823,CNC1177,0,356,0,356,0,1,0,1,0,0
824,CND3037,356,1357,75,1363,79,872,73,876,281,6
825,CNE2161,0,356,356,0,0,1,1,0,356,356
826,CNF0212,0,356,0,356,0,1,0,1,0,0
827,CNH3475,383,373,114,367,93,18,100,11,269,6
828,CNK1711,290,346,0,356,1,1,0,1,290,10
829,CNP1183,0,356,0,356,0,1,0,1,0,0
830,CNR1031,0,356,0,356,0,1,0,1,0,0
831,CNS2548,0,356,0,356,0,1,0,1,0,0
832,CNT0946,381,373,465,11,94,18,99,11,84,362
833,CNT1188,0,356,356,0,0,1,1,0,356,356
834,CNW2408,0,356,0,356,0,1,0,1,0,0
835,COB0461,54,806,50,810,52,547,48,549,4,4
836,COD2351,0,356,0,356,0,1,0,1,0,0
837,COK3383,193,163,0,356,1,1,0,1,193,193
838,COW3840,0,356,0,356,0,1,0,1,0,0
839,CPC0724,465,549,91,551,91,63,82,71,374,2
840,CPM1627,61,79,79,0,1,1,1,0,18,79
841,CPP0623,0,356,0,356,0,1,0,1,0,0
842,CPP2909,0,218,117,101,0,1,1,1,117,117
843,CPR1800,0,356,356,0,0,1,1,0,356,356
844,CPT1533,281,356,356,0,1,1,1,0,75,356
845,CQA3849,0,203,0,203,0,1,0,1,0,0
846,CQC0997,0,356,0,356,0,1,0,1,0,0
847,CQH1505,0,356,356,0,0,1,1,0,356,356
848,CQS2883,328,476,18,443,20,8,17,10,310,33
849,CRC0348,23,556,49,530,22,14,25,12,26,26
850,CRC0595,0,356,0,356,0,1,0,1,0,0
851,CRC2747,0,356,0,356,0,1,0,1,0,0
852,CRE2652,0,303,161,142,0,1,1,1,161,161
853,CRH3848,0,356,0,356,0,1,0,1,0,0
854,CRJ3070,0,356,356,0,0,1,1,0,356,356
855,CRL2357,276,441,0,441,1,1,0,1,276,0
856,CRL3842,0,356,0,356,0,1,0,1,0,0
857,CRM0139,56,514,54,516,54,43,52,45,2,2
858,CRP1186,0,356,356,0,0,1,1,0,356,356
859,CRP1915,356,0,0,356,1,0,0,1,356,356
860,CRP2489,76,381,74,383,68,26,68,28,2,2
861,CRP3682,361,351,370,62,13,2,14,1,9,289
862,CRT2273,0,356,2,354,0,1,1,1,2,2
863,CSB0827,0,356,0,356,0,1,0,1,0,0
864,CSB1660,2,367,2,367,2,12,2,12,0,0
865,CSB2910,319,362,224,176,39,7,39,7,95,186
866,CSB3932,296,358,209,168,20,3,21,2,87,190
867,CSC0233,0,356,356,0,0,1,1,0,356,356
868,CSC3074,0,356,0,356,0,1,0,1,0,0
869,CSE1265,0,356,188,168,0,1,1,1,188,188
870,CSG0135,356,0,0,356,1,0,0,1,356,356
871,CSG1600,0,356,356,0,0,1,1,0,356,356
872,CSL0428,282,385,356,29,1,1,1,1,74,356
873,CSL2055,337,376,48,377,48,20,46,21,289,1
874,CSM1212,44,368,45,367,42,13,43,12,1,1
875,CSM1554,334,382,55,381,53,25,54,24,279,1
876,CSM1565,0,356,0,356,0,1,0,1,0,0
877,CSM2819,52,365,47,370,46,10,42,14,5,5
878,CSM3502,305,382,0,398,1,1,0,1,305,16
879,CSP0483,0,355,356,0,0,1,1,0,356,355
880,CSP2186,301,358,380,0,21,3,23,0,79,358
881,CSP3434,0,356,0,356,0,1,0,1,0,0
882,CSR0612,0,356,356,0,0,1,1,0,356,356
883,CSR1682,0,356,0,356,0,1,0,1,0,0
884,CSR3140,195,241,128,123,11,3,12,2,67,118
885,CSR3225,2,384,1,385,2,29,1,30,1,1
886,CSS1313,0,379,201,178,0,1,1,1,201,201
887,CST2863,0,356,184,172,0,1,1,1,184,184
888,CSV3305,0,356,0,356,0,1,0,1,0,0
889,CSW3811,0,266,0,266,0,1,0,1,0,0
890,CTB3481,292,359,14,360,14,4,12,5,278,1
891,CTC0421,275,356,356,0,1,1,1,0,81,356
892,CTC0859,154,182,196,0,15,2,16,0,42,182
893,CTD1850,0,355,0,356,0,1,0,1,0,1
894,CTG3770,0,356,0,356,0,1,0,1,0,0
895,CTH0626,359,381,73,381,67,25,68,24,286,0
896,CTH0737,275,357,356,0,1,1,1,0,81,357
897,CTH0915,276,387,188,199,1,1,1,1,88,188
898,CTH2220,273,360,0,356,1,1,0,1,273,4
899,CTH3020,0,356,0,356,0,1,0,1,0,0
900,CTJ0669,0,356,194,162,0,1,1,1,194,194
901,CTJ2794,95,376,96,375,80,20,80,20,1,1
902,CTK0947,80,276,356,0,1,1,1,0,276,276
903,CTM1961,0,356,0,356,0,1,0,1,0,0
904,CTP2225,382,498,466,93,99,40,108,30,84,405
905,CTP3877,0,356,356,0,0,1,1,0,356,356
906,CTW2038,61,78,78,0,1,1,1,0,17,78
907,CUL3015,0,356,0,356,0,1,0,1,0,0
908,CUM2335,0,356,0,356,0,1,0,1,0,0
909,CUP2764,0,356,356,0,0,1,1,0,356,356
910,CUQ3097,0,356,198,158,0,1,1,1,198,198
911,CVB2703,357,371,446,7,74,16,83,7,89,364
912,CWA2549,0,174,0,174,0,1,0,1,0,0
913,CWA2554,307,457,21,416,22,9,21,9,286,41
914,CWB1463,190,166,0,356,1,1,0,1,190,190
915,CWC0490,310,368,31,364,27,13,31,9,279,4
916,CWF1289,0,355,192,164,0,1,1,1,192,191
917,CWH0038,0,356,0,356,0,1,0,1,0,0
918,CWH3033,0,356,356,0,0,1,1,0,356,356
919,CWH3487,0,356,0,356,0,1,0,1,0,0
920,CWK2870,297,362,210,169,18,7,22,3,87,193
921,CWL0561,0,356,0,356,0,1,0,1,0,0
922,CWP1829,0,356,0,356,0,1,0,1,0,0
923,CWR0043,90,1285,85,1290,89,808,84,812,5,5
924,CWR0117,0,356,356,0,0,1,1,0,356,356
925,CWT3747,0,356,0,356,0,1,0,1,0,0
926,CXB2183,0,356,356,0,0,1,1,0,356,356
927,CXK3433,0,356,45,311,0,1,1,1,45,45
928,CXM1821,0,593,0,593,0,1,0,1,0,0
929,CYO1575,351,392,84,389,76,36,77,32,267,3
930,CZB3718,0,356,0,356,0,1,0,1,0,0
931,CZT2970,0,356,356,0,0,1,1,0,356,356
932,DAB0166,356,0,0,356,1,0,0,1,356,356
933,DAB2580,2,375,2,375,2,20,2,20,0,0
934,DAB3255,236,246,308,7,66,17,73,7,72,239
935,DAD1785,33,44,1,44,2,3,1,3,32,0
936,DAD2620,356,0,0,356,1,0,0,1,356,356
937,DAE1437,381,604,97,520,90,49,88,50,284,84
938,DAF3096,0,99,47,52,0,1,1,1,47,47
939,DAH2506,175,222,222,0,1,1,1,0,47,222
940,DAH3324,0,356,0,356,0,1,0,1,0,0
941,DAH3331,0,356,0,356,0,1,0,1,0,0
942,DAL1943,0,355,356,0,0,1,1,0,356,355
943,DAM0096,46,369,45,370,46,14,45,15,1,1
944,DAM2705,0,356,356,0,0,1,1,0,356,356
945,DAM2837,0,356,187,169,0,1,1,1,187,187
946,DAM2954,464,175,0,356,1,1,0,1,464,181
947,DAM3359,0,356,0,356,0,1,0,1,0,0
948,DAM3691,0,356,356,0,0,1,1,0,356,356
949,DAR0388,6,394,362,38,6,31,7,31,356,356
950,DAR0709,280,577,366,115,1,1,1,1,86,462
951,DAR3637,0,356,0,356,0,1,0,1,0,0
952,DAS1955,0,147,0,147,0,1,0,1,0,0
953,DAS3775,0,356,0,356,0,1,0,1,0,0
954,DAT1981,337,0,35,169,37,0,32,5,302,169
955,DBB3846,277,356,0,356,1,1,0,1,277,0
956,DBC1073,16,340,0,356,1,1,0,1,16,16
957,DBC1152,0,356,356,0,0,1,1,0,356,356
958,DBC3871,353,452,437,58,65,35,71,26,84,394
959,DBF3582,301,364,16,365,18,9,16,10,285,1
960,DBF3635,371,520,94,485,89,55,85,57,277,35
961,DBG0477,645,62,7,418,8,3,7,3,638,356
962,DBG3320,0,356,0,356,0,1,0,1,0,0
963,DBG3727,0,356,0,356,0,1,0,1,0,0
964,DBH1596,79,371,442,8,75,16,82,8,363,363
965,DBL2605,0,356,0,356,0,1,0,1,0,0
966,DBR1558,77,99,0,99,1,1,0,1,77,0
967,DBR1798,0,356,356,0,0,1,1,0,356,356
968,DBS0880,5,351,0,356,1,1,0,1,5,5
969,DBS1363,0,356,0,356,0,1,0,1,0,0
970,DBT0141,381,402,98,405,95,28,91,31,283,3
971,DBV2736,0,356,0,356,0,1,0,1,0,0
972,DBW3679,0,356,0,356,0,1,0,1,0,0
973,DCB0401,287,354,0,356,1,1,0,1,287,2
974,DCB3597,0,229,229,0,0,1,1,0,229,229
975,DCC1431,281,356,0,356,1,1,0,1,281,0
976,DCC2999,299,366,214,169,22,7,23,6,85,197
977,DCC3689,25,359,382,2,24,4,26,2,357,357
978,DCF2185,0,356,356,0,0,1,1,0,356,356
979,DCG2203,0,356,0,356,0,1,0,1,0,0
980,DCM3288,0,356,0,356,0,1,0,1,0,0
981,DCM3596,306,695,380,226,18,10,18,10,74,469
982,DCR1531,352,377,440,11,70,22,77,11,88,366
983,DCW0174,0,356,356,0,0,1,1,0,356,356
984,DCW1901,0,356,356,0,0,1,1,0,356,356
985,DCW2405,341,418,31,416,37,20,31,25,310,2
986,DDC0980,376,382,463,18,87,26,95,17,87,364
987,DDF2937,165,159,0,324,1,1,0,1,165,165
988,DDG0528,273,356,356,0,1,1,1,0,83,356
989,DDG1703,0,356,0,356,0,1,0,1,0,0
990,DDG1822,0,356,0,356,0,1,0,1,0,0
991,DDH1041,266,356,0,356,1,1,0,1,266,0
992,DDL3007,0,356,0,356,0,1,0,1,0,0
993,DDS3149,0,356,193,163,0,1,1,1,193,193
994,DDW3361,0,356,0,356,0,1,0,1,0,0
995,DEF0998,281,356,356,0,1,1,1,0,75,356
996,DEL0913,0,356,188,168,0,1,1,1,188,188
997,DEN0236,0,356,356,0,0,1,1,0,356,356
998,DEP0163,364,388,93,388,83,32,81,33,271,0
999,DER0400,0,356,0,356,0,1,0,1,0,0
1000,DER2162,110,370,473,7,101,14,109,7,363,363
1001,DEY2638,0,356,179,177,0,1,1,1,179,179
1002,DFC2060,0,529,0,529,0,1,0,1,0,0
1003,DFC3287,0,356,0,356,0,1,0,1,0,0
1004,DFH1681,0,356,0,356,0,1,0,1,0,0
1005,DFM2933,296,358,216,160,19,3,21,1,80,198
1006,DFP3615,331,366,408,8,49,11,51,8,77,358
1007,DFW1467,0,356,356,0,0,1,1,0,356,356
1008,DGE3194,0,257,257,0,0,1,1,0,257,257
1009,DGG3429,34,336,65,305,31,11,35,8,31,31
1010,DGH3295,0,356,0,356,0,1,0,1,0,0
1011,DGN3358,16,414,17,413,16,3,17,2,1,1
1012,DGQ3744,3,387,5,386,3,23,5,21,2,1
1013,DGS1079,277,356,0,356,1,1,0,1,277,0
1014,DHB2364,0,356,0,356,0,1,0,1,0,0
1015,DHC1989,0,356,0,356,0,1,0,1,0,0
1016,DHG0533,326,359,407,3,49,4,49,3,81,356
1017,DHG0962,307,356,377,0,20,1,20,0,70,356
1018,DHG1830,357,368,70,372,67,13,63,16,287,4
1019,DHK0367,3,370,181,192,3,9,4,9,178,178
1020,DHL2219,273,360,0,356,1,1,0,1,273,4
1021,DHM1476,0,356,356,0,0,1,1,0,356,356
1022,DHR2541,275,356,0,356,1,1,0,1,275,0
1023,DHS2419,363,457,447,90,81,39,85,35,84,367
1024,DIA0731,21,335,0,356,1,1,0,1,21,21
1025,DIP3310,281,356,0,356,1,1,0,1,281,0
1026,DIR3921,0,356,356,0,0,1,1,0,356,356
1027,DIW1749,0,356,191,165,0,1,1,1,191,191
1028,DJA0740,317,508,395,92,30,14,32,12,78,416
1029,DJB1236,156,192,12,191,12,7,12,6,144,1
1030,DJB2983,0,230,230,0,0,1,1,0,230,230
1031,DJC0073,0,356,0,356,0,1,0,1,0,0
1032,DJF0760,182,174,0,356,1,1,0,1,182,182
1033,DJF2329,348,382,76,372,61,27,64,24,272,10
1034,DJF2576,0,356,0,356,0,1,0,1,0,0
1035,DJF3394,462,171,0,356,1,1,0,1,462,185
1036,DJH0971,362,399,454,36,86,44,93,36,92,363
1037,DJH1506,298,394,366,39,11,1,11,1,68,355
1038,DJP2420,0,186,186,0,0,1,1,0,186,186
1039,DJP3230,0,356,0,356,0,1,0,1,0,0
1040,DJR2389,0,356,190,166,0,1,1,1,190,190
1041,DJS1127,285,590,365,165,1,1,1,1,80,425
1042,DJS1271,271,356,198,158,1,1,1,1,73,198
1043,DKB0260,51,410,51,410,45,55,44,54,0,0
1044,DKD2409,174,221,221,0,1,1,1,0,47,221
1045,DKE0797,0,356,0,356,0,1,0,1,0,0
1046,DKF2721,0,356,356,0,0,1,1,0,356,356
1047,DKM2980,0,356,356,0,0,1,1,0,356,356
1048,DKP0671,274,356,192,164,1,1,1,1,82,192
1049,DKR0027,2,354,0,356,1,1,0,1,2,2
1050,DKR0860,9,422,365,66,8,1,9,1,356,356
1051,DKS1509,0,356,356,0,0,1,1,0,356,356
1052,DKW1659,0,356,0,356,0,1,0,1,0,0
1053,DLC2903,0,356,0,356,0,1,0,1,0,0
1054,DLG2673,0,356,356,0,0,1,1,0,356,356
1055,DLM0608,0,356,190,166,0,1,1,1,190,190
1056,DLM1680,355,422,84,422,78,33,79,33,271,0
1057,DLM2440,372,1314,263,1140,87,851,80,857,109,174
1058,DLM2826,272,359,189,167,1,1,1,1,83,192
1059,DLP1445,187,169,0,356,1,1,0,1,187,187
1060,DLR1423,0,356,0,356,0,1,0,1,0,0
1061,DLW2729,0,333,0,333,0,1,0,1,0,0
1062,DMA3455,13,343,23,333,1,1,1,1,10,10
1063,DMB1429,375,378,99,375,89,23,91,20,276,3
1064,DMB2533,0,355,356,0,0,1,1,0,356,355
1065,DMC1438,0,356,0,356,0,1,0,1,0,0
1066,DMC1766,93,1318,446,965,90,840,88,841,353,353
1067,DMD0486,0,356,356,0,0,1,1,0,356,356
1068,DMG1298,0,356,196,160,0,1,1,1,196,196
1069,DMH0011,0,477,361,116,0,1,1,1,361,361
1070,DMH1232,289,363,16,362,15,8,15,7,273,1
1071,DMJ1815,0,356,0,356,0,1,0,1,0,0
1072,DMM2063,0,157,0,157,0,1,0,1,0,0
1073,DMR0336,0,356,0,356,0,1,0,1,0,0
1074,DMR2518,0,356,356,0,0,1,1,0,356,356
1075,DMS1977,241,277,0,296,1,1,0,1,241,19
1076,DMS3400,464,172,0,356,1,1,0,1,464,184
1077,DMW2128,297,361,372,3,15,6,16,3,75,358
1078,DNB1999,314,381,39,382,41,26,39,27,275,1
1079,DNB2574,0,436,0,436,0,1,0,1,0,0
1080,DNB3545,87,110,0,110,1,1,0,1,87,0
1081,DND3309,0,356,0,356,0,1,0,1,0,0
1082,DNH0308,0,356,356,0,0,1,1,0,356,356
1083,DNM0275,61,392,61,392,59,19,58,19,0,0
1084,DNM2823,281,356,0,356,1,1,0,1,281,0
1085,DNM3903,0,356,0,356,0,1,0,1,0,0
1086,DNN0488,0,356,0,356,0,1,0,1,0,0
1087,DNS1758,498,1719,570,1317,193,1064,191,1064,72,402
1088,DNS1768,376,1359,451,1007,98,855,95,859,75,352
1089,DNV1964,47,387,48,386,46,20,47,19,1,1
1090,DOB2696,0,356,356,0,0,1,1,0,356,356
1091,DOC1734,0,356,356,0,0,1,1,0,356,356
1092,DOM0586,0,50,0,50,0,1,0,1,0,0
1093,DOS1990,339,392,64,389,61,35,62,34,275,3
1094,DOT1898,0,281,281,0,0,1,1,0,281,281
1095,DOW1266,0,356,188,168,0,1,1,1,188,188
1096,DPC3722,277,360,0,356,1,1,0,1,277,4
1097,DPF3215,264,367,356,0,1,1,1,0,92,367
1098,DPF3360,0,35,0,35,0,1,0,1,0,0
1099,DPM2971,24,53,30,20,6,5,7,4,6,33
1100,DQS0752,0,356,356,0,0,1,1,0,356,356
1101,DRB0202,282,515,361,87,1,1,1,1,79,428
1102,DRB0756,187,169,0,356,1,1,0,1,187,187
1103,DRB1780,0,355,0,356,0,1,0,1,0,1
1104,DRC2296,285,386,356,32,1,1,1,1,71,354
1105,DRD0097,0,356,0,356,0,1,0,1,0,0
1106,DRF1498,353,520,437,88,62,20,67,15,84,432
1107,DRF3306,0,356,0,356,0,1,0,1,0,0
1108,DRF3992,0,356,0,356,0,1,0,1,0,0
1109,DRH3557,335,434,419,75,58,16,60,12,84,359
1110,DRJ0794,0,356,0,356,0,1,0,1,0,0
1111,DRK3644,0,247,0,247,0,1,0,1,0,0
1112,DRM2927,0,356,182,174,0,1,1,1,182,182
1113,DRN0782,0,363,0,363,0,1,0,1,0,0
1114,DRS0032,0,356,0,356,0,1,0,1,0,0
1115,DRW1207,274,356,0,356,1,1,0,1,274,0
1116,DSA3620,348,382,443,15,66,26,74,14,95,367
1117,DSB0245,47,372,245,174,46,17,51,12,198,198
1118,DSB0307,0,356,356,0,0,1,1,0,356,356
1119,DSB2463,356,0,0,356,1,0,0,1,356,356
1120,DSB2734,0,356,0,356,0,1,0,1,0,0
1121,DSC2208,0,356,0,356,0,1,0,1,0,0
1122,DSD1293,0,356,190,166,0,1,1,1,190,190
1123,DSF2557,0,356,0,356,0,1,0,1,0,0
1124,DSJ1384,280,356,356,0,1,1,1,0,76,356
1125,DSM1286,370,382,303,178,95,26,103,16,67,204
1126,DSM2400,0,356,185,171,0,1,1,1,185,185
1127,DSM3954,0,356,189,167,0,1,1,1,189,189
1128,DSN3186,272,356,356,0,1,1,1,0,84,356
1129,DSR3787,0,429,0,429,0,1,0,1,0,0
1130,DTA2223,290,356,356,0,1,1,1,0,66,356
1131,DTC2566,78,375,75,378,69,20,69,23,3,3
1132,DTG1294,306,450,206,262,19,8,22,5,100,188
1133,DTH1333,261,313,329,29,46,14,51,8,68,284
1134,DTL2891,354,424,66,426,62,5,60,7,288,2
1135,DTT1716,0,356,356,0,0,1,1,0,356,356
1136,DTU3804,283,452,0,412,1,1,0,1,283,40
1137,DTW1276,0,356,192,164,0,1,1,1,192,192
1138,DTW3549,0,356,0,356,0,1,0,1,0,0
1139,DWB0238,8,399,370,37,8,19,9,19,362,362
1140,DWB0865,0,355,356,0,0,1,1,0,356,355
1141,DWB3085,382,378,97,376,79,23,80,21,285,2
1142,DWB3415,0,356,0,356,0,1,0,1,0,0
1143,DWC2994,0,356,0,356,0,1,0,1,0,0
1144,DWD2621,356,0,0,356,1,0,0,1,356,356
1145,DWF2268,0,356,0,356,0,1,0,1,0,0
1146,DWK2099,303,332,31,325,1,1,1,1,272,7
1147,DWY3973,0,356,0,356,0,1,0,1,0,0
1148,DXM2433,107,1346,284,1169,107,898,101,904,177,177
1149,DYH0315,0,356,0,356,0,1,0,1,0,0
1150,DZG0889,381,399,109,395,98,11,101,7,272,4
1151,DZW0126,0,356,0,356,0,1,0,1,0,0
1152,EAB2522,0,356,356,0,0,1,1,0,356,356
1153,EAH1653,290,368,15,365,18,6,15,10,275,3
1154,EAH2882,0,355,0,356,0,1,0,1,0,1
1155,EAH3107,0,356,356,0,0,1,1,0,356,356
1156,EAH3550,0,356,0,356,0,1,0,1,0,0
1157,EAL3873,250,499,317,171,42,32,47,27,67,328
1158,EAM1432,276,356,0,356,1,1,0,1,276,0
1159,EAM3642,0,356,0,356,0,1,0,1,0,0
1160,EAP1555,0,356,0,356,0,1,0,1,0,0
1161,EBC3242,0,356,0,356,0,1,0,1,0,0
1162,EBD2562,352,379,63,378,61,24,61,23,289,1
1163,EBH1882,0,356,356,0,0,1,1,0,356,356
1164,EBS2201,386,375,459,16,90,20,92,16,73,359
1165,ECA0976,0,356,356,0,0,1,1,0,356,356
1166,ECA1221,0,356,0,356,0,1,0,1,0,0
1167,ECB1341,0,356,356,0,0,1,1,0,356,356
1168,ECB1683,5,456,5,456,5,22,5,22,0,0
1169,ECM3591,0,356,356,0,0,1,1,0,356,356
1170,ECS3353,105,374,104,375,93,18,93,19,1,1
1171,EDF2361,322,366,44,367,44,10,43,11,278,1
1172,EDJ1970,283,556,0,471,1,1,0,1,283,85
1173,EDP1880,0,356,356,0,0,1,1,0,356,356
1174,EDV1427,0,356,0,356,0,1,0,1,0,0
1175,EEC3193,303,360,377,3,20,5,21,3,74,357
1176,EEH0965,289,356,356,0,1,1,1,0,67,356
1177,EFC1153,0,356,356,0,0,1,1,0,356,356
1178,EFJ1685,0,356,0,356,0,1,0,1,0,0
1179,EGB3624,0,356,356,0,0,1,1,0,356,356
1180,EGC0931,363,374,451,13,84,17,87,12,88,361
1181,EGD3972,188,270,1,270,2,24,1,24,187,0
1182,EGG3374,0,356,0,356,0,1,0,1,0,0
1183,EGP2104,0,356,0,356,0,1,0,1,0,0
1184,EHB0942,0,373,356,17,0,1,1,1,356,356
1185,EHD0024,191,165,193,163,1,1,1,1,2,2
1186,EHD1744,79,96,48,51,4,2,4,2,31,45
1187,EHV1237,0,356,0,356,0,1,0,1,0,0
1188,EHW2450,0,356,356,0,0,1,1,0,356,356
1189,EID1076,184,236,0,236,1,1,0,1,184,0
1190,EIF1865,0,356,356,0,0,1,1,0,356,356
1191,EIH0064,356,0,0,356,1,0,0,1,356,356
1192,EIR1046,388,1423,103,1421,101,886,99,886,285,2
1193,EIY2749,0,356,0,356,0,1,0,1,0,0
1194,EJB1263,0,356,0,356,0,1,0,1,0,0
1195,EJG0833,1,357,1,357,1,2,1,2,0,0
1196,EJG1655,0,356,0,356,0,1,0,1,0,0
1197,EJH2799,287,369,4,371,7,14,4,16,283,2
1198,EJL1075,8,367,7,368,8,12,7,13,1,1
1199,EJM2690,261,360,0,356,1,1,0,1,261,4
1200,EJP2315,0,356,9,347,0,1,1,1,9,9
1201,EJP2975,314,554,387,114,22,23,23,22,73,440
1202,EJS1338,358,372,439,11,69,17,72,11,81,361
1203,EKB0825,0,356,0,356,0,1,0,1,0,0
1204,EKB3828,0,356,0,356,0,1,0,1,0,0
1205,EKC3706,105,361,465,1,93,6,98,1,360,360
1206,EKH0934,272,356,356,0,1,1,1,0,84,356
1207,EKH2084,313,358,218,163,24,3,25,2,95,195
1208,EKK0503,0,356,0,356,0,1,0,1,0,0
1209,EKM0863,0,356,356,0,0,1,1,0,356,356
1210,EKN3760,264,356,0,356,1,1,0,1,264,0
1211,EKS3724,266,417,0,413,1,1,0,1,266,4
1212,EKV3321,0,356,0,356,0,1,0,1,0,0
1213,ELB0033,317,520,29,457,31,15,29,16,288,63
1214,ELB3697,302,337,372,0,16,1,16,0,70,337
1215,ELC1833,0,356,0,356,0,1,0,1,0,0
1216,ELR1140,278,356,356,0,1,1,1,0,78,356
1217,ELW1413,342,444,82,439,69,19,68,19,260,5
1218,EMC2757,0,356,356,0,0,1,1,0,356,356
1219,EMC3609,0,356,356,0,0,1,1,0,356,356
1220,EMH1957,0,356,1,355,0,1,1,1,1,1
1221,EMK3809,317,561,35,507,30,11,34,6,282,54
1222,EMM3195,0,185,185,0,0,1,1,0,185,185
1223,EMO0159,0,356,356,0,0,1,1,0,356,356
1224,EMO2120,0,356,356,0,0,1,1,0,356,356
1225,EMR3880,0,402,0,402,0,1,0,1,0,0
1226,EMS1736,0,356,356,0,0,1,1,0,356,356
1227,ENH3969,164,201,8,203,11,6,8,8,156,2
1228,ENM2269,355,373,76,374,71,18,68,19,279,1
1229,ENR1304,279,356,198,158,1,1,1,1,81,198
1230,ENS1748,292,599,183,311,1,1,1,1,109,288
1231,EPC3889,268,356,0,356,1,1,0,1,268,0
1232,EPH2834,4,415,191,228,4,8,4,9,187,187
1233,EPI3052,124,1364,119,1369,116,837,112,840,5,5
1234,EPM3878,0,356,0,356,0,1,0,1,0,0
1235,EPW3971,278,356,0,356,1,1,0,1,278,0
1236,EQT0195,270,356,356,0,1,1,1,0,86,356
1237,ERA0725,291,381,14,382,16,4,14,5,277,1
1238,ERC1840,19,337,0,356,1,1,0,1,19,19
1239,ERD1235,44,369,45,368,42,14,43,13,1,1
1240,ERF2472,436,13,78,371,74,13,71,16,358,358
1241,ERG3905,302,360,17,362,20,5,17,7,285,2
1242,ERH0815,49,368,52,365,46,13,49,10,3,3
1243,ERO2454,0,356,356,0,0,1,1,0,356,356
1244,ESB2629,278,356,186,170,1,1,1,1,92,186
1245,ESB2888,0,356,0,356,0,1,0,1,0,0
1246,ESH1283,382,374,298,181,89,19,92,16,84,193
1247,ESH2077,306,359,223,165,28,4,28,4,83,194
1248,ESN2683,0,356,0,356,0,1,0,1,0,0
1249,ESS3318,105,372,108,369,91,16,95,13,3,3
1250,ESS3341,380,374,95,378,88,19,83,22,285,4
1251,ETA0791,0,356,0,356,0,1,0,1,0,0
1252,ETB0828,0,356,0,356,0,1,0,1,0,0
1253,ETB0950,286,356,362,0,7,1,7,0,76,356
1254,ETG2821,297,359,11,360,13,4,11,5,286,1
1255,ETM2542,0,356,0,356,0,1,0,1,0,0
1256,EUC1051,382,1393,98,1396,100,871,96,873,284,3
1257,EUH0257,0,356,0,356,0,1,0,1,0,0
1258,EUV1842,357,278,0,356,1,1,0,1,357,78
1259,EVF1722,0,356,0,356,0,1,0,1,0,0
1260,EVO1522,0,356,356,0,0,1,1,0,356,356
1261,EWA1486,0,356,356,0,0,1,1,0,356,356
1262,EYD2871,302,398,211,207,20,3,21,2,91,191
1263,EZB3892,271,356,0,356,1,1,0,1,271,0
1264,EZP3568,285,358,356,0,1,1,1,0,71,358
1265,FAD3114,0,356,356,0,0,1,1,0,356,356
1266,FAH1566,0,356,0,356,0,1,0,1,0,0
1267,FAH1851,0,356,0,356,0,1,0,1,0,0
1268,FAJ0523,280,396,356,40,1,1,1,1,76,356
1269,FAJ3101,275,356,356,0,1,1,1,0,81,356
1270,FAJ3608,21,408,308,121,21,6,22,6,287,287
1271,FAL1867,277,355,356,0,1,1,1,0,79,355
1272,FAP0199,26,385,385,26,26,30,30,26,359,359
1273,FAR2869,0,356,190,166,0,1,1,1,190,190
1274,FAW1969,303,369,21,370,22,14,20,15,282,1
1275,FBD2277,0,356,33,323,0,1,1,1,33,33
1276,FBM2755,0,356,356,0,0,1,1,0,356,356
1277,FBM3728,0,356,0,356,0,1,0,1,0,0
1278,FBY1064,26,330,0,356,1,1,0,1,26,26
1279,FCB0563,0,356,0,356,0,1,0,1,0,0
1280,FCE0695,0,356,356,0,0,1,1,0,356,356
1281,FCK3307,0,356,0,356,0,1,0,1,0,0
1282,FCM2190,292,359,369,3,14,4,14,3,77,356
1283,FCM3792,0,356,0,356,0,1,0,1,0,0
1284,FCM3926,0,356,356,0,0,1,1,0,356,356
1285,FCS1128,355,373,443,11,72,17,78,11,88,362
1286,FCS2824,355,416,265,207,67,32,71,28,90,209
1287,FCY1157,0,356,0,356,0,1,0,1,0,0
1288,FCY1819,0,356,0,356,0,1,0,1,0,0
1289,FDD1052,92,1333,89,1336,90,876,87,878,3,3
1290,FDD3893,314,415,47,415,46,12,45,11,267,0
1291,FDF2135,99,126,123,18,20,8,22,6,24,108
1292,FDF3743,373,390,88,391,85,34,81,36,285,1
1293,FDH0299,191,175,0,366,1,1,0,1,191,191
1294,FDM1933,0,356,356,0,0,1,1,0,356,356
1295,FDS0810,274,356,0,356,1,1,0,1,274,0
1296,FDT0213,281,356,0,356,1,1,0,1,281,0
1297,FDV1224,0,429,0,429,0,1,0,1,0,0
1298,FES3442,0,356,0,356,0,1,0,1,0,0
1299,FFP2270,302,383,19,373,20,2,19,2,283,10
1300,FFP3169,3,353,61,295,1,1,1,1,58,58
1301,FGC0114,300,498,375,87,11,33,12,32,75,411
1302,FGG3666,0,356,0,356,0,1,0,1,0,0
1303,FGH1958,0,356,0,356,0,1,0,1,0,0
1304,FGK1026,181,175,0,356,1,1,0,1,181,181
1305,FGN0375,0,356,191,165,0,1,1,1,191,191
1306,FGS3275,0,356,0,356,0,1,0,1,0,0
1307,FHA3387,496,377,17,478,18,10,16,11,479,101
1308,FHM2067,354,400,82,390,71,45,79,35,272,10
1309,FJA1848,54,308,0,362,1,1,0,1,54,54
1310,FJC2198,0,356,356,0,0,1,1,0,356,356
1311,FJO1828,329,427,55,430,56,11,52,14,274,3
1312,FKA0393,0,356,356,0,0,1,1,0,356,356
1313,FKD2779,267,356,0,356,1,1,0,1,267,0
1314,FKH0804,180,176,0,356,1,1,0,1,180,180
1315,FKJ1521,0,356,356,0,0,1,1,0,356,356
1316,FKM1622,279,366,359,4,1,1,1,1,80,362
1317,FKR3316,0,356,0,356,0,1,0,1,0,0
1318,FKS0094,277,356,0,356,1,1,0,1,277,0
1319,FLS0231,0,356,0,356,0,1,0,1,0,0
1320,FMC1002,0,356,0,356,0,1,0,1,0,0
1321,FMN0013,0,356,0,356,0,1,0,1,0,0
1322,FMR0920,222,201,174,94,63,7,67,3,48,107
1323,FMS3285,265,356,0,356,1,1,0,1,265,0
1324,FMT2152,0,356,356,0,0,1,1,0,356,356
1325,FNB1512,0,345,345,0,0,1,1,0,345,345
1326,FNM1482,0,356,356,0,0,1,1,0,356,356
1327,FNM2124,0,356,356,0,0,1,1,0,356,356
1328,FNR0635,356,0,0,356,1,0,0,1,356,356
1329,FNW3564,169,254,234,12,1,1,1,1,65,242
1330,FPL3129,0,356,356,0,0,1,1,0,356,356
1331,FPM2074,279,356,189,167,1,1,1,1,90,189
1332,FPV3755,346,372,65,371,63,17,63,16,281,1
1333,FQG2974,0,356,356,0,0,1,1,0,356,356
1334,FQL3629,0,356,356,0,0,1,1,0,356,356
1335,FRB3653,305,365,16,363,15,10,16,8,289,2
1336,FRG1576,344,390,67,389,62,33,62,33,277,1
1337,FRM3431,0,356,38,318,0,1,1,1,38,38
1338,FSM0056,296,364,376,5,18,9,21,5,80,359
1339,FSP0703,282,356,356,0,1,1,1,0,74,356
1340,FTF1665,0,356,0,356,0,1,0,1,0,0
1341,FTS0246,291,388,371,31,15,3,16,2,80,357
1342,FVK1623,0,356,356,0,0,1,1,0,356,356
1343,FVR0881,362,403,86,387,82,13,79,14,276,16
1344,FXD3105,375,384,462,16,85,29,96,16,87,368
1345,FYP1187,310,375,356,51,1,1,1,1,46,324
1346,FZB3046,400,1394,121,1399,127,901,121,905,279,5
1347,FZM0318,192,213,33,213,33,9,32,9,159,0
1348,FZS0969,0,356,356,0,0,1,1,0,356,356
1349,FZW2101,0,356,0,356,0,1,0,1,0,0
1350,GAA3681,1,355,356,0,1,1,1,0,355,355
1351,GAB1206,0,356,0,356,0,1,0,1,0,0
1352,GAB1885,0,356,356,0,0,1,1,0,356,356
1353,GAB3758,293,416,5,420,10,17,5,21,288,4
1354,GAC2529,0,356,356,0,0,1,1,0,356,356
1355,GAF2480,636,103,0,429,1,1,0,1,636,326
1356,GAH0525,352,510,426,91,60,22,62,20,74,419
1357,GAH1760,85,1282,433,934,82,813,75,819,348,348
1358,GAN1584,345,428,421,69,60,20,62,18,76,359
1359,GAP0715,346,387,68,387,69,27,64,31,278,0
1360,GAW0808,0,356,0,356,0,1,0,1,0,0
1361,GBB3816,287,356,0,356,1,1,0,1,287,0
1362,GBC0907,360,402,272,206,70,13,73,7,88,196
1363,GBH1126,268,356,356,0,1,1,1,0,88,356
1364,GBJ3604,0,356,356,0,0,1,1,0,356,356
1365,GCB0201,0,356,356,0,0,1,1,0,356,356
1366,GCD1189,282,354,356,0,1,1,1,0,74,354
1367,GCH0735,0,356,356,0,0,1,1,0,356,356
1368,GCJ0831,0,219,0,219,0,1,0,1,0,0
1369,GCK2071,0,356,0,356,0,1,0,1,0,0
1370,GCL1782,285,355,0,356,1,1,0,1,285,1
1371,GCM0813,0,356,0,356,0,1,0,1,0,0
1372,GCM1580,0,22,0,22,0,1,0,1,0,0
1373,GCN1743,38,414,233,221,36,10,39,7,195,193
1374,GCP2425,384,1340,282,1160,98,868,92,872,102,180
1375,GCR2597,11,344,0,356,1,1,0,1,11,12
1376,GCS2218,269,360,0,356,1,1,0,1,269,4
1377,GCT3750,0,356,0,356,0,1,0,1,0,0
1378,GDB2960,195,161,0,356,1,1,0,1,195,195
1379,GDF3524,0,30,30,0,0,1,1,0,30,30
1380,GDG2354,9,347,0,356,1,1,0,1,9,9
1381,GDH0108,1,355,0,356,1,1,0,1,1,1
1382,GDH2500,346,559,61,521,54,28,57,25,285,38
1383,GDH3546,0,356,0,356,0,1,0,1,0,0
1384,GDM3835,0,356,0,356,0,1,0,1,0,0
1385,GDM3960,350,683,52,571,48,54,47,51,298,112
1386,GDP1856,0,356,356,0,0,1,1,0,356,356
1387,GDR1066,19,337,0,356,1,1,0,1,19,19
1388,GDS3165,0,356,192,164,0,1,1,1,192,192
1389,GDY2724,360,448,77,440,66,29,69,23,283,8
1390,GEB3079,0,356,0,356,0,1,0,1,0,0
1391,GEB3975,277,356,0,356,1,1,0,1,277,0
1392,GEG2093,8,414,6,416,8,11,6,13,2,2
1393,GEH0420,0,356,356,0,0,1,1,0,356,356
1394,GEH3406,486,173,22,361,25,4,22,6,464,188
1395,GEK3441,0,356,0,356,0,1,0,1,0,0
1396,GER1997,289,411,15,405,16,4,15,4,274,6
1397,GES2626,282,619,190,309,1,1,1,1,92,310
1398,GFB1385,360,389,458,20,82,34,93,20,98,369
1399,GFJ2582,387,408,107,407,92,26,90,26,280,1
1400,GFK3498,67,391,70,388,63,23,65,21,3,3
1401,GFP2144,0,356,356,0,0,1,1,0,356,356
1402,GFV3163,0,356,181,175,0,1,1,1,181,181
1403,GGB3663,0,355,0,356,0,1,0,1,0,1
1404,GGH1726,0,356,189,167,0,1,1,1,189,189
1405,GGM3737,349,460,77,463,77,41,70,46,272,3
1406,GHD1450,453,251,0,430,1,1,0,1,453,179
1407,GHM3953,0,356,199,157,0,1,1,1,199,199
1408,GHT3177,10,346,48,308,1,1,1,1,38,38
1409,GIB0207,0,356,0,356,0,1,0,1,0,0
1410,GIH0882,294,381,18,379,12,4,12,4,276,2
1411,GIM0786,0,356,0,356,0,1,0,1,0,0
1412,GIS1668,0,356,0,356,0,1,0,1,0,0
1413,GIT2266,273,356,0,356,1,1,0,1,273,0
1414,GJB0850,197,159,0,356,1,1,0,1,197,197
1415,GJB2659,294,360,223,156,20,5,23,2,71,204
1416,GJD1141,282,356,356,0,1,1,1,0,74,356
1417,GJG0170,0,356,192,164,0,1,1,1,192,192
1418,GJG0852,280,363,356,7,1,1,1,1,76,356
1419,GJG1087,287,342,0,356,1,1,0,1,287,14
1420,GJM0065,352,0,8,196,9,0,8,1,344,196
1421,GJM0838,194,162,0,356,1,1,0,1,194,194
1422,GJM2800,269,437,0,437,1,1,0,1,269,0
1423,GJO3614,0,356,356,0,0,1,1,0,356,356
1424,GJS0160,356,648,80,563,75,87,73,87,276,85
1425,GJS0494,0,356,0,356,0,1,0,1,0,0
1426,GJS3352,86,383,91,378,78,26,82,21,5,5
1427,GJT1292,0,356,178,178,0,1,1,1,178,178
1428,GKA3690,0,356,356,0,0,1,1,0,356,356
1429,GKB1150,0,242,242,0,0,1,1,0,242,242
1430,GKB2807,276,356,0,356,1,1,0,1,276,0
1431,GKG2763,0,356,356,0,0,1,1,0,356,356
1432,GKG3414,403,450,120,421,100,25,100,25,283,29
1433,GKH1634,0,356,356,0,0,1,1,0,356,356
1434,GKK2422,285,356,356,0,1,1,1,0,71,356
1435,GKL0006,338,586,415,154,48,15,49,14,77,432
1436,GKL1516,0,356,356,0,0,1,1,0,356,356
1437,GKN0168,0,356,356,0,0,1,1,0,356,356
1438,GKW2306,0,356,356,0,0,1,1,0,356,356
1439,GLB0419,0,356,356,0,0,1,1,0,356,356
1440,GLC3495,31,325,0,356,1,1,0,1,31,31
1441,GLF0226,0,356,356,0,0,1,1,0,356,356
1442,GLG1573,96,120,17,120,17,16,16,16,79,0
1443,GLM3106,0,356,356,0,0,1,1,0,356,356
1444,GLM3450,0,356,0,356,0,1,0,1,0,0
1445,GLN2107,298,362,15,362,16,7,15,7,283,0
1446,GLR3888,0,356,0,356,0,1,0,1,0,0
1447,GLS1193,0,356,356,0,0,1,1,0,356,356
1448,GMA1698,273,356,0,356,1,1,0,1,273,0
1449,GMB3703,0,441,356,85,0,1,1,1,356,356
1450,GMC0953,1,355,356,0,1,1,1,0,355,355
1451,GMC1209,220,232,38,234,36,16,34,18,182,2
1452,GMF1213,295,359,16,358,16,4,16,3,279,1
1453,GMH2027,0,336,0,336,0,1,0,1,0,0
1454,GMI1134,365,409,446,45,74,16,82,8,81,364
1455,GMK1449,469,163,0,356,1,1,0,1,469,193
1456,GMM0224,356,368,450,4,76,13,82,4,94,364
1457,GMY3938,0,268,149,119,0,1,1,1,149,149
1458,GNA0183,0,356,192,164,0,1,1,1,192,192
1459,GNB3337,38,68,0,58,1,1,0,1,38,10
1460,GNC2237,266,356,356,0,1,1,1,0,90,356
1461,GND1618,342,369,427,9,63,14,65,9,85,360
1462,GNE1365,313,560,24,500,22,26,22,25,289,60
1463,GNG2362,0,355,0,356,0,1,0,1,0,1
1464,GNG2812,0,355,0,356,0,1,0,1,0,1
1465,GNH1735,0,356,2,354,0,1,1,1,2,2
1466,GNT0221,282,429,8,402,9,5,8,5,274,27
1467,GNW3891,0,356,0,356,0,1,0,1,0,0
1468,GOB3528,270,357,356,0,1,1,1,0,86,357
1469,GOG3939,0,356,193,163,0,1,1,1,193,193
1470,GOM0090,0,356,0,356,0,1,0,1,0,0
1471,GOR0861,0,356,356,0,0,1,1,0,356,356
1472,GPB2691,284,358,0,356,1,1,0,1,284,2
1473,GPD3917,71,373,434,10,66,18,72,10,363,363
1474,GPL1911,356,0,0,356,1,0,0,1,356,356
1475,GRA0329,0,356,0,356,0,1,0,1,0,0
1476,GRG3005,0,356,356,0,0,1,1,0,356,356
1477,GRL2886,0,356,0,356,0,1,0,1,0,0
1478,GRL3110,0,356,356,0,0,1,1,0,356,356
1479,GRM1511,0,239,224,15,0,1,1,1,224,224
1480,GRM3793,0,356,0,356,0,1,0,1,0,0
1481,GRP0277,352,524,67,483,64,63,60,66,285,41
1482,GRP1402,0,356,0,356,0,1,0,1,0,0
1483,GRY1398,22,433,22,433,21,19,21,19,0,0
1484,GSA2720,0,356,356,0,0,1,1,0,356,356
1485,GSA3815,0,356,0,356,0,1,0,1,0,0
1486,GSB0666,0,356,192,164,0,1,1,1,192,192
1487,GSC0192,0,356,0,356,0,1,0,1,0,0
1488,GSC0530,353,432,448,64,71,18,80,6,95,368
1489,GSH1593,0,356,356,0,0,1,1,0,356,356
1490,GSM0930,80,375,441,14,76,20,82,14,361,361
1491,GSS0841,189,167,0,356,1,1,0,1,189,189
1492,GST1100,0,356,356,0,0,1,1,0,356,356
1493,GTC0747,40,368,401,7,37,13,43,7,361,361
1494,GTG1348,0,356,356,0,0,1,1,0,356,356
1495,GTH3729,0,356,0,356,0,1,0,1,0,0
1496,GTL3389,185,180,7,358,8,3,7,3,178,178
1497,GUC0473,356,0,0,356,1,0,0,1,356,356
1498,GUC3945,281,429,194,206,1,1,1,1,87,223
1499,GVC0049,20,300,20,300,20,219,20,219,0,0
1500,GVC1358,306,358,384,1,26,3,27,1,78,357
1501,GWC0137,356,0,0,356,1,0,0,1,356,356
1502,GWM1366,0,356,0,356,0,1,0,1,0,0
1503,GWM3260,394,442,472,75,100,15,107,5,78,367
1504,GWW3788,0,356,0,356,0,1,0,1,0,0
1505,GYH3476,283,373,362,16,7,17,7,16,79,357
1506,GYM1926,0,356,356,0,0,1,1,0,356,356
1507,GYO2169,0,356,356,0,0,1,1,0,356,356
1508,GYS2461,356,0,0,356,1,0,0,1,356,356
1509,GZM3990,279,356,0,356,1,1,0,1,279,0
1510,HAC1300,0,356,181,175,0,1,1,1,181,181
1511,HAF0394,339,409,427,46,57,15,62,8,88,363
1512,HAF1891,36,46,46,0,1,1,1,0,10,46
1513,HAG3196,337,535,420,110,57,20,57,20,83,425
1514,HAG3665,0,356,0,356,0,1,0,1,0,0
1515,HAH3895,0,356,0,356,0,1,0,1,0,0
1516,HAL1200,0,356,356,0,0,1,1,0,356,356
1517,HAM2252,0,356,356,0,0,1,1,0,356,356
1518,HAP3000,0,356,356,0,0,1,1,0,356,356
1519,HAP3738,279,384,0,382,1,1,0,1,279,2
1520,HAR1101,0,356,356,0,0,1,1,0,356,356
1521,HAR3571,168,211,211,0,1,1,1,0,43,211
1522,HAR3632,274,357,0,356,1,1,0,1,274,1
1523,HBB1759,482,1347,566,986,193,889,198,884,84,361
1524,HBC0081,215,255,56,251,51,28,55,25,159,4
1525,HBC0999,346,477,63,477,59,37,59,37,283,0
1526,HBC1540,0,356,0,356,0,1,0,1,0,0
1527,HBC3497,0,356,0,356,0,1,0,1,0,0
1528,HBD1371,281,356,0,356,1,1,0,1,281,0
1529,HBH2368,289,356,0,356,1,1,0,1,289,0
1530,HBM0676,105,374,304,175,89,19,95,13,199,199
1531,HBM2126,0,356,356,0,0,1,1,0,356,356
1532,HBS0255,0,356,356,0,0,1,1,0,356,356
1533,HBS2551,286,356,0,356,1,1,0,1,286,0
1534,HCB1383,359,420,443,54,70,27,78,18,84,366
1535,HCB1643,288,356,356,0,1,1,1,0,68,356
1536,HCF2857,107,130,75,65,11,3,13,1,32,65
1537,HCH3338,0,356,0,356,0,1,0,1,0,0
1538,HCH3685,285,356,356,0,1,1,1,0,71,356
1539,HCM2945,196,160,0,356,1,1,0,1,196,196
1540,HCO3108,0,356,356,0,0,1,1,0,356,356
1541,HCR1322,277,356,191,165,1,1,1,1,86,191
1542,HCR3675,0,356,0,356,0,1,0,1,0,0
1543,HCS2231,332,482,406,74,42,18,46,14,74,408
1544,HCS2401,279,356,0,356,1,1,0,1,279,0
1545,HDB1666,275,730,0,605,1,1,0,1,275,125
1546,HDC0789,0,356,0,356,0,1,0,1,0,0
1547,HDC2132,0,356,356,0,0,1,1,0,356,356
1548,HDG2848,269,356,176,180,1,1,1,1,93,176
1549,HDH3751,0,356,0,356,0,1,0,1,0,0
1550,HDK0634,757,5,108,371,106,5,96,16,649,366
1551,HDL2297,0,356,356,0,0,1,1,0,356,356
1552,HDN1139,374,414,467,48,87,21,96,12,93,366
1553,HDN2609,359,397,77,388,69,20,67,19,282,9
1554,HDP1890,330,489,405,76,34,16,38,12,75,413
1555,HDT0242,181,161,0,342,1,1,0,1,181,181
1556,HEB3754,280,361,0,360,1,1,0,1,280,1
1557,HES2103,6,402,8,401,6,7,8,5,2,1
1558,HET0359,362,387,80,391,77,30,74,34,282,4
1559,HEW2164,0,356,356,0,0,1,1,0,356,356
1560,HFF2540,0,356,0,356,0,1,0,1,0,0
1561,HGD1664,0,416,0,416,0,1,0,1,0,0
1562,HGH0727,0,435,0,435,0,1,0,1,0,0
1563,HGJ2592,362,403,60,440,57,14,55,16,302,37
1564,HGR0198,0,356,356,0,0,1,1,0,356,356
1565,HHD2393,347,379,424,18,62,22,65,17,77,361
1566,HHF1995,298,497,7,444,8,12,6,13,291,53
1567,HHG1038,0,356,0,356,0,1,0,1,0,0
1568,HHK0652,0,356,192,164,0,1,1,1,192,192
1569,HHL2311,280,356,356,0,1,1,1,0,76,356
1570,HHM0869,338,444,422,85,62,10,65,7,84,359
1571,HHS3357,0,356,0,356,0,1,0,1,0,0
1572,HHW2471,356,0,0,356,1,0,0,1,356,356
1573,HIA2415,309,367,393,9,35,12,36,9,84,358
1574,HID1899,354,517,432,94,62,26,65,22,78,423
1575,HIF0482,0,226,226,0,0,1,1,0,226,226
1576,HIP0148,293,360,373,2,16,5,18,2,80,358
1577,HIS1706,0,357,356,1,0,1,1,1,356,356
1578,HJA0779,298,360,371,4,16,5,16,4,73,356
1579,HJB0220,0,356,0,356,0,1,0,1,0,0
1580,HJB0286,0,356,0,356,0,1,0,1,0,0
1581,HJD3439,326,360,87,312,37,7,38,4,239,48
1582,HJG2157,377,373,463,13,94,18,97,13,86,360
1583,HJG3868,0,356,356,0,0,1,1,0,356,356
1584,HJH2588,53,303,0,356,1,1,0,1,53,53
1585,HJH2977,0,356,356,0,0,1,1,0,356,356
1586,HJR1160,14,342,0,356,1,1,0,1,14,14
1587,HJR2127,0,356,356,0,0,1,1,0,356,356
1588,HJR3540,0,356,356,0,0,1,1,0,356,356
1589,HJV1586,0,356,356,0,0,1,1,0,356,356
1590,HJW2646,276,356,198,158,1,1,1,1,78,198
1591,HKA0686,0,356,356,0,0,1,1,0,356,356
1592,HKD1826,0,356,0,356,0,1,0,1,0,0
1593,HKH0204,369,411,461,49,90,26,95,21,92,362
1594,HKK2716,296,366,374,5,13,10,17,5,78,361
1595,HKM3016,278,356,0,356,1,1,0,1,278,0
1596,HKR2901,0,356,0,356,0,1,0,1,0,0
1597,HKT1778,277,356,0,356,1,1,0,1,277,0
1598,HKW2615,649,0,0,356,1,0,0,1,649,356
1599,HLC0943,358,381,436,17,66,23,70,16,78,364
1600,HLC1172,74,375,73,376,70,20,68,21,1,1
1601,HLD1109,0,356,0,356,0,1,0,1,0,0
1602,HLD1270,0,356,195,161,0,1,1,1,195,195
1603,HLM1007,0,356,356,0,0,1,1,0,356,356
1604,HLM1564,0,356,0,356,0,1,0,1,0,0
1605,HLO2756,28,526,392,162,24,22,28,18,364,364
1606,HLS2098,281,351,8,348,1,1,1,1,273,3
1607,HLS2733,0,356,0,356,0,1,0,1,0,0
1608,HLZ2414,36,39,43,4,9,5,9,4,7,35
1609,HMA1258,0,356,0,356,0,1,0,1,0,0
1610,HMB0805,484,435,3,509,5,6,3,7,481,74
1611,HMC0592,0,356,0,356,0,1,0,1,0,0
1612,HMG0642,356,0,0,356,1,0,0,1,356,356
1613,HMM2628,9,514,213,310,9,7,11,6,204,204
1614,HMM2768,285,362,369,5,13,7,14,5,84,357
1615,HMM2841,0,356,185,171,0,1,1,1,185,185
1616,HMP3391,202,154,0,356,1,1,0,1,202,202
1617,HMR0098,0,575,357,218,0,1,1,1,357,357
1618,HMS2212,0,356,0,356,0,1,0,1,0,0
1619,HMS3795,0,356,0,356,0,1,0,1,0,0
1620,HMT1024,0,356,0,356,0,1,0,1,0,0
1621,HMV2340,0,356,0,356,0,1,0,1,0,0
1622,HMY0235,306,707,390,247,26,21,27,20,84,460
1623,HNB2571,9,385,9,385,9,7,9,6,0,0
1624,HNB3661,365,395,88,394,79,39,76,38,277,1
1625,HNC0074,319,362,396,3,35,7,37,3,77,359
1626,HNG1909,355,0,0,356,1,0,0,1,355,356
1627,HNM3405,540,257,81,449,78,13,76,15,459,192
1628,HNV3655,0,356,0,356,0,1,0,1,0,0
1629,HOE0301,181,175,0,356,1,1,0,1,181,181
1630,HOJ2172,0,356,356,0,0,1,1,0,356,356
1631,HPR2023,0,89,0,89,0,1,0,1,0,0
1632,HQB0118,0,356,0,356,0,1,0,1,0,0
1633,HQB3494,136,334,97,373,85,15,82,17,39,39
1634,HQF1912,356,49,0,405,1,1,0,1,356,356
1635,HRF2044,0,356,0,356,0,1,0,1,0,0
1636,HRK2972,0,356,356,0,0,1,1,0,356,356
1637,HRL2565,0,355,0,356,0,1,0,1,0,1
1638,HSA2065,352,435,78,433,67,19,71,17,274,2
1639,HSF1454,192,164,0,356,1,1,0,1,192,192
1640,HSH0292,0,356,356,0,0,1,1,0,356,356
1641,HSH3606,403,495,484,79,102,25,107,20,81,416
1642,HSK0639,658,62,17,402,18,6,16,7,641,340
1643,HSP1675,281,356,0,356,1,1,0,1,281,0
1644,HSS3959,0,356,0,356,0,1,0,1,0,0
1645,HTC1750,0,422,185,237,0,1,1,1,185,185
1646,HTR1551,10,400,34,376,10,7,10,8,24,24
1647,HUC1396,283,356,1,355,1,1,1,1,282,1
1648,HUM0431,0,356,356,0,0,1,1,0,356,356
1649,HUM2481,356,0,0,356,1,0,0,1,356,356
1650,HVR0633,650,1,21,361,24,1,20,6,629,360
1651,HVS1143,0,356,356,0,0,1,1,0,356,356
1652,HWC3907,0,206,0,206,0,1,0,1,0,0
1653,HWP0364,286,356,0,356,1,1,0,1,286,0
1654,HWS2915,0,180,99,81,0,1,1,1,99,99
1655,HWV1621,0,320,320,0,0,1,1,0,320,320
1656,HYF1048,98,1309,94,1313,96,849,92,852,4,4
1657,HYK3300,279,356,0,356,1,1,0,1,279,0
1658,HYP1591,0,356,356,0,0,1,1,0,356,356
1659,HYV1658,0,356,0,356,0,1,0,1,0,0
1660,HZA3839,0,356,0,356,0,1,0,1,0,0
1661,HZD0429,0,356,0,356,0,1,0,1,0,0
1662,HZH0297,486,176,21,364,21,9,20,9,465,188
1663,HZM3056,0,356,356,0,0,1,1,0,356,356
1664,IAA3012,0,356,0,356,0,1,0,1,0,0
1665,IAB3386,188,168,0,356,1,1,0,1,188,188
1666,IAC3581,281,356,0,356,1,1,0,1,281,0
1667,IAG2742,0,356,0,356,0,1,0,1,0,0
1668,IAM3078,285,420,0,399,1,1,0,1,285,21
1669,IAR1895,0,356,356,0,0,1,1,0,356,356
1670,IAR3996,0,356,0,356,0,1,0,1,0,0
1671,IAS0857,0,434,356,78,0,1,1,1,356,356
1672,IBC0377,272,364,197,167,1,1,1,1,75,197
1673,IBM1700,0,356,0,356,0,1,0,1,0,0
1674,IBM1752,0,356,189,167,0,1,1,1,189,189
1675,IBP1616,390,727,463,263,84,55,87,51,73,464
1676,IBP2990,0,356,356,0,0,1,1,0,356,356
1677,IBV1578,55,73,0,73,1,1,0,1,55,0
1678,IBW1779,0,373,0,373,0,1,0,1,0,0
1679,ICB3167,0,191,0,191,0,1,0,1,0,0
1680,ICF2294,0,356,356,0,0,1,1,0,356,356
1681,ICH1478,0,356,356,0,0,1,1,0,356,356
1682,ICH2378,365,74,8,431,10,3,8,4,357,357
1683,ICL0565,0,356,0,356,0,1,0,1,0,0
1684,ICP3710,0,356,356,0,0,1,1,0,356,356
1685,IDB1059,92,1361,88,1365,91,885,87,890,4,4
1686,IDC2568,0,356,0,356,0,1,0,1,0,0
1687,IDF0189,386,473,299,240,84,33,94,25,87,233
1688,IDH2939,195,161,0,356,1,1,0,1,195,195
1689,IDL2014,0,356,0,356,0,1,0,1,0,0
1690,IDW1211,0,356,0,356,0,1,0,1,0,0
1691,IEG2687,361,448,88,445,82,35,81,36,273,3
1692,IEG3509,0,356,187,169,0,1,1,1,187,187
1693,IFC0958,15,85,78,22,15,7,18,5,63,63
1694,IFS0793,0,356,0,356,0,1,0,1,0,0
1695,IGB1902,0,356,356,0,0,1,1,0,356,356
1696,IGP1784,15,419,16,418,15,18,16,17,1,1
1697,IGP2254,371,381,98,380,90,24,88,25,273,1
1698,IHB0288,0,361,0,361,0,1,0,1,0,0
1699,IHD1978,356,0,0,356,1,0,0,1,356,356
1700,IHH2590,0,356,0,356,0,1,0,1,0,0
1701,IHH2831,0,356,192,164,0,1,1,1,192,192
1702,IHS0816,279,356,0,356,1,1,0,1,279,0
1703,IHW2112,279,356,0,356,1,1,0,1,279,0
1704,IIB2553,0,356,0,356,0,1,0,1,0,0
1705,IIF2584,0,356,0,356,0,1,0,1,0,0
1706,IIG0772,0,356,356,0,0,1,1,0,356,356
1707,IIM1947,275,356,356,0,1,1,1,0,81,356
1708,IIW0036,287,356,0,356,1,1,0,1,287,0
1709,IIW0361,0,356,356,0,0,1,1,0,356,356
1710,IIW0399,279,356,0,356,1,1,0,1,279,0
1711,IIW1595,280,356,356,0,1,1,1,0,76,356
1712,IJC1553,0,291,6,285,0,1,1,1,6,6
1713,IJC2459,356,0,0,356,1,0,0,1,356,356
1714,IJC3881,0,356,0,356,0,1,0,1,0,0
1715,IJM3356,278,356,0,356,1,1,0,1,278,0
1716,IJS1090,0,69,0,69,0,1,0,1,0,0
1717,IKA2925,107,368,293,182,93,13,98,10,186,186
1718,IKC1205,306,580,17,505,16,12,17,10,289,75
1719,IKG3154,0,356,178,178,0,1,1,1,178,178
1720,IKH3472,58,298,0,356,1,1,0,1,58,58
1721,IKK3333,0,356,0,356,0,1,0,1,0,0
1722,IKM1808,39,410,38,411,37,16,36,17,1,1
1723,IKP1047,229,895,51,900,54,582,50,585,178,5
1724,IKT0917,11,139,73,77,11,1,12,1,62,62
1725,ILH0248,0,356,0,356,0,1,0,1,0,0
1726,ILH2989,376,443,473,73,97,22,110,8,97,370
1727,ILK3668,250,373,0,374,1,1,0,1,250,1
1728,ILS0713,0,356,356,0,0,1,1,0,356,356
1729,ILY3152,294,411,219,215,24,18,22,20,75,196
1730,IMC3296,59,553,59,553,48,62,51,63,0,0
1731,IMH0562,18,411,15,414,17,24,14,27,3,3
1732,IMH2964,0,356,356,0,0,1,1,0,356,356
1733,IMM2118,0,356,356,0,0,1,1,0,356,356
1734,IMM3253,0,356,356,0,0,1,1,0,356,356
1735,IMN1730,282,356,356,0,1,1,1,0,74,356
1736,IMP0960,0,356,356,0,0,1,1,0,356,356
1737,IMR3660,80,400,77,403,72,43,72,46,3,3
1738,IMS0862,61,387,354,94,59,23,63,19,293,293
1739,IMS2191,0,356,356,0,0,1,1,0,356,356
1740,INB3109,0,356,356,0,0,1,1,0,356,356
1741,ING2221,0,356,0,356,0,1,0,1,0,0
1742,INH1250,0,356,1,355,0,1,1,1,1,1
1743,INJ3876,0,326,326,0,0,1,1,0,326,326
1744,INL3041,87,1349,82,1354,85,881,80,886,5,5
1745,INR0927,0,356,356,0,0,1,1,0,356,356
1746,INS3200,0,356,356,0,0,1,1,0,356,356
1747,IOF3298,0,104,0,104,0,1,0,1,0,0
1748,IOM0542,12,344,356,0,1,1,1,0,344,344
1749,IOP1859,0,356,356,0,0,1,1,0,356,356
1750,IOR0152,0,356,188,168,0,1,1,1,188,188
1751,IPB1935,0,356,356,0,0,1,1,0,356,356
1752,IPK2575,0,483,0,483,0,1,0,1,0,0
1753,IPS0385,184,234,120,114,1,1,1,1,64,120
1754,IQO1690,0,356,0,356,0,1,0,1,0,0
1755,IQR2187,295,363,373,6,17,8,18,6,78,357
1756,IRB2456,275,356,356,0,1,1,1,0,81,356
1757,IRC3952,296,415,198,224,8,2,8,2,98,191
1758,IRO0822,0,356,0,356,0,1,0,1,0,0
1759,IRP2018,280,374,16,358,1,1,1,1,264,16
1760,IRP3916,0,369,356,13,0,1,1,1,356,356
1761,IRS1337,310,545,386,101,21,7,21,7,76,444
1762,IRT2811,0,356,0,356,0,1,0,1,0,0
1763,IRW2130,0,355,356,0,0,1,1,0,356,355
1764,ISB0256,299,579,378,125,18,10,19,9,79,454
1765,ISG2025,0,356,0,356,0,1,0,1,0,0
1766,ISH0051,279,356,356,0,1,1,1,0,77,356
1767,ISH0079,0,356,0,356,0,1,0,1,0,0
1768,ISJ1479,353,551,421,119,58,27,59,26,68,432
1769,ISM0130,0,356,187,169,0,1,1,1,187,187
1770,ISM2612,0,301,0,301,0,1,0,1,0,0
1771,ISR0021,34,360,392,2,33,5,34,2,358,358
1772,ISR1364,55,385,57,383,52,30,53,28,2,2
1773,ISR1477,266,356,356,0,1,1,1,0,90,356
1774,ISS0949,4,352,356,0,1,1,1,0,352,352
1775,ITK2781,0,356,0,356,0,1,0,1,0,0
1776,ITM0906,0,356,0,356,0,1,0,1,0,0
1777,IUT3421,293,356,0,356,1,1,0,1,293,0
1778,IWB3257,293,370,369,13,13,15,14,13,76,357
1779,IWG0058,346,551,438,120,68,46,74,38,92,431
1780,IWR3469,121,131,17,131,17,4,16,4,104,0
1781,IWW0699,277,356,356,0,1,1,1,0,79,356
1782,IWW3319,0,165,0,165,0,1,0,1,0,0
1783,IYM3865,272,356,356,0,1,1,1,0,84,356
1784,JAA0897,0,356,28,328,0,1,1,1,28,28
1785,JAB2131,0,356,356,0,0,1,1,0,356,356
1786,JAB3656,280,439,9,439,10,5,9,5,271,0
1787,JAC2001,0,356,0,356,0,1,0,1,0,0
1788,JAD3672,0,356,0,356,0,1,0,1,0,0
1789,JAF0209,284,492,187,276,1,1,1,1,97,216
1790,JAM1676,0,356,0,356,0,1,0,1,0,0
1791,JAM2248,0,356,356,0,0,1,1,0,356,356
1792,JAO3463,325,374,58,375,58,19,57,20,267,1
1793,JAS0353,0,356,356,0,0,1,1,0,356,356
1794,JAS1907,631,0,0,356,1,0,0,1,631,356
1795,JAW0551,197,258,0,258,1,1,0,1,197,0
1796,JAW3813,274,356,0,356,1,1,0,1,274,0
1797,JAY3851,310,546,20,473,24,14,20,17,290,73
1798,JBB0847,526,188,51,382,50,21,45,25,475,194
1799,JBB1875,0,356,356,0,0,1,1,0,356,356
1800,JBB3280,0,356,0,356,0,1,0,1,0,0
1801,JBC1916,356,0,0,356,1,0,0,1,356,356
1802,JBD3707,0,356,356,0,0,1,1,0,356,356
1803,JBH2559,0,356,0,356,0,1,0,1,0,0
1804,JBI0654,0,356,190,166,0,1,1,1,190,190
1805,JBL2993,284,356,356,0,1,1,1,0,72,356
1806,JBL3189,0,356,356,0,0,1,1,0,356,356
1807,JBM2769,0,356,356,0,0,1,1,0,356,356
1808,JBM3933,43,373,235,181,43,17,44,17,192,192
1809,JBO2839,0,356,194,162,0,1,1,1,194,194
1810,JBP0651,0,356,190,166,0,1,1,1,190,190
1811,JBS1291,0,356,195,161,0,1,1,1,195,195
1812,JBT1035,0,189,0,189,0,1,0,1,0,0
1813,JBW0109,356,389,83,388,73,14,74,13,273,1
1814,JBW2054,76,95,0,95,1,1,0,1,76,0
1815,JBW3852,295,358,18,359,18,3,16,4,277,1
1816,JCB2089,53,366,54,365,46,11,48,10,1,1
1817,JCB2350,0,356,0,356,0,1,0,1,0,0
1818,JCB3054,117,1385,113,1389,114,879,110,881,4,4
1819,JCC0059,0,251,251,0,0,1,1,0,251,251
1820,JCC0571,0,356,0,356,0,1,0,1,0,0
1821,JCC0736,0,356,356,0,0,1,1,0,356,356
1822,JCC1381,0,356,356,0,0,1,1,0,356,356
1823,JCC2287,287,356,356,0,1,1,1,0,69,356
1824,JCF0800,0,21,0,21,0,1,0,1,0,0
1825,JCG1982,356,0,0,356,1,0,0,1,356,356
1826,JCH1410,0,356,0,356,0,1,0,1,0,0
1827,JCH1952,0,356,0,356,0,1,0,1,0,0
1828,JCH2505,296,451,375,67,14,5,15,4,79,384
1829,JCH2963,188,168,0,356,1,1,0,1,188,188
1830,JCH3456,0,356,0,356,0,1,0,1,0,0
1831,JCJ2572,0,301,0,301,0,1,0,1,0,0
1832,JCL0446,273,441,7,441,8,5,7,5,266,0
1833,JCM1388,340,373,424,12,60,17,65,12,84,361
1834,JCM1803,0,356,356,0,0,1,1,0,356,356
1835,JCP0028,0,356,0,356,0,1,0,1,0,0
1836,JCP1462,181,290,0,471,1,1,0,1,181,181
1837,JCP3883,18,399,18,399,18,4,18,4,0,0
1838,JCR1148,300,417,373,60,17,4,18,3,73,357
1839,JCR1536,0,356,2,354,0,1,1,1,2,2
1840,JCR3919,281,356,356,0,1,1,1,0,75,356
1841,JCS0380,0,356,184,172,0,1,1,1,184,184
1842,JCS2391,338,376,67,372,66,17,64,17,271,4
1843,JCW1332,0,356,356,0,0,1,1,0,356,356
1844,JDB0738,284,356,356,0,1,1,1,0,72,356
1845,JDB0956,3,353,356,0,1,1,1,0,353,353
1846,JDB1620,93,391,454,30,80,35,85,30,361,361
1847,JDB3127,0,356,356,0,0,1,1,0,356,356
1848,JDC2176,290,377,382,20,25,8,27,6,92,357
1849,JDC3713,0,356,0,356,0,1,0,1,0,0
1850,JDH0295,0,356,356,0,0,1,1,0,356,356
1851,JDH1027,175,181,0,356,1,1,0,1,175,175
1852,JDH1550,282,356,3,353,1,1,1,1,279,3
1853,JDH3762,0,356,0,356,0,1,0,1,0,0
1854,JDM0165,356,0,0,356,1,0,0,1,356,356
1855,JDM1042,299,704,12,608,16,7,12,10,287,96
1856,JDR0436,0,356,204,152,0,1,1,1,204,204
1857,JDS0516,0,222,0,222,0,1,0,1,0,0
1858,JDV1245,278,356,0,356,1,1,0,1,278,0
1859,JEH2787,376,386,96,389,89,29,87,31,280,3
1860,JEH2847,0,356,184,172,0,1,1,1,184,184
1861,JEL2887,317,317,0,356,1,1,0,1,317,39
1862,JEM0546,291,514,0,445,1,1,0,1,291,69
1863,JEP1571,90,108,0,108,1,1,0,1,90,0
1864,JET2299,270,550,360,108,1,1,1,1,90,442
1865,JEV3132,282,555,379,144,18,22,20,19,97,411
1866,JEW2035,0,356,356,0,0,1,1,0,356,356
1867,JEW2141,286,497,358,90,1,1,1,1,72,407
1868,JFB0961,50,321,371,0,16,1,16,0,321,321
1869,JFB2168,76,370,437,9,70,14,75,9,361,361
1870,JFG1049,360,1409,76,1412,79,919,75,921,284,3
1871,JFL2674,353,374,442,11,75,18,82,10,89,363
1872,JFO2840,261,437,192,242,1,1,1,1,69,195
1873,JFR3527,302,361,378,2,20,6,23,2,76,359
1874,JGH0493,1,355,0,356,1,1,0,1,1,1
1875,JGH0728,0,356,0,356,0,1,0,1,0,0
1876,JGM3588,0,356,0,356,0,1,0,1,0,0
1877,JGN1767,81,1362,435,1008,80,879,79,878,354,354
1878,JGR2327,0,356,39,317,0,1,1,1,39,39
1879,JGR3488,0,356,0,356,0,1,0,1,0,0
1880,JGR3914,35,368,396,7,34,13,40,7,361,361
1881,JGW1274,0,244,126,118,0,1,1,1,126,126
1882,JHB0807,0,30,0,30,0,1,0,1,0,0
1883,JHC1809,0,356,0,356,0,1,0,1,0,0
1884,JHC3520,0,356,190,166,0,1,1,1,190,190
1885,JHD2499,278,356,0,356,1,1,0,1,278,0
1886,JHE3080,365,370,86,369,78,15,79,14,279,1
1887,JHF0480,0,406,356,50,0,1,1,1,356,356
1888,JHF1278,290,361,212,168,20,6,21,5,78,193
1889,JHF1356,282,356,356,0,1,1,1,0,74,356
1890,JHH2770,0,356,356,0,0,1,1,0,356,356
1891,JHH3462,21,361,23,359,21,6,23,4,2,2
1892,JHK1849,80,506,73,513,65,38,63,42,7,7
1893,JHK3122,282,410,356,50,1,11,1,11,74,360
1894,JHM0583,329,380,60,378,54,25,55,23,269,2
1895,JHP1799,275,357,356,0,1,1,1,0,81,357
1896,JIB1218,0,356,0,356,0,1,0,1,0,0
1897,JIB2606,93,383,96,380,82,27,82,25,3,3
1898,JIG1936,0,356,356,0,0,1,1,0,356,356
1899,JIM2988,292,356,366,0,11,1,11,0,74,356
1900,JIN3522,286,361,367,5,12,6,12,5,81,356
1901,JIP3170,7,349,87,269,1,1,1,1,80,80
1902,JIR2594,304,503,24,446,25,14,23,15,280,57
1903,JIR2827,11,360,198,173,11,5,12,5,187,187
1904,JIW2086,0,356,196,160,0,1,1,1,196,196
1905,JJA1399,0,356,0,356,0,1,0,1,0,0
1906,JJB0042,85,1312,80,1317,84,855,79,857,5,5
1907,JJB1598,0,415,356,59,0,1,1,1,356,356
1908,JJB2367,0,356,0,356,0,1,0,1,0,0
1909,JJB3398,181,175,0,356,1,1,0,1,181,181
1910,JJC0116,0,129,129,0,0,1,1,0,129,129
1911,JJE1552,0,356,0,356,0,1,0,1,0,0
1912,JJF1325,0,356,356,0,0,1,1,0,356,356
1913,JJH0681,329,394,53,389,48,24,51,19,276,5
1914,JJH1389,8,473,7,475,8,18,7,19,1,2
1915,JJH1818,0,356,0,356,0,1,0,1,0,0
1916,JJH2332,278,375,5,374,7,18,5,19,273,1
1917,JJJ1267,0,356,177,179,0,1,1,1,177,177
1918,JJL1448,586,178,119,365,103,9,100,10,467,187
1919,JJM2845,0,356,199,157,0,1,1,1,199,199
1920,JJM3791,8,370,8,370,8,15,8,15,0,0
1921,JJS2079,277,356,191,165,1,1,1,1,86,191
1922,JJS2973,0,463,357,106,0,1,1,1,357,357
1923,JJS3884,272,356,3,353,1,1,1,1,269,3
1924,JJY3112,0,356,356,0,0,1,1,0,356,356
1925,JKC2754,363,617,437,198,62,52,65,47,74,419
1926,JKC3349,0,356,0,356,0,1,0,1,0,0
1927,JKD1115,338,382,68,382,64,27,62,27,270,0
1928,JKF1825,0,356,0,356,0,1,0,1,0,0
1929,JKG0944,0,506,363,143,0,1,1,1,363,363
1930,JKG3329,298,360,22,361,22,4,19,6,276,1
1931,JKH3673,283,356,0,356,1,1,0,1,283,0
1932,JKK1422,300,365,19,368,23,10,19,13,281,3
1933,JKS2444,118,207,153,30,1,1,1,1,35,177
1934,JKW0200,0,356,356,0,0,1,1,0,356,356
1935,JLA0030,0,356,0,356,0,1,0,1,0,0
1936,JLC0216,288,611,0,518,1,1,0,1,288,93
1937,JLF3219,0,288,0,288,0,1,0,1,0,0
1938,JLF3346,0,355,0,356,0,1,0,1,0,1
1939,JLG2952,479,163,0,356,1,1,0,1,479,193
1940,JLG3764,0,356,0,356,0,1,0,1,0,0
1941,JLL1204,0,356,0,356,0,1,0,1,0,0
1942,JLL1813,0,128,0,128,0,1,0,1,0,0
1943,JLM3150,0,355,189,167,0,1,1,1,189,188
1944,JLM3847,137,236,5,207,6,4,5,4,132,29
1945,JLR0313,3,356,358,2,3,3,3,2,355,354
1946,JLR0632,0,356,0,356,0,1,0,1,0,0
1947,JLR3930,0,356,190,166,0,1,1,1,190,190
1948,JLW2924,0,356,187,169,0,1,1,1,187,187
1949,JLW3598,0,356,356,0,0,1,1,0,356,356
1950,JMB1651,0,356,0,356,0,1,0,1,0,0
1951,JMB2246,88,390,446,32,82,35,85,32,358,358
1952,JMC2806,0,356,0,356,0,1,0,1,0,0
1953,JMC2911,0,356,189,167,0,1,1,1,189,189
1954,JME0387,273,358,356,0,1,1,1,0,83,358
1955,JMF3362,0,324,0,325,0,1,0,1,0,1
1956,JMG3365,370,372,88,370,76,17,76,15,282,2
1957,JMG3704,0,356,356,0,0,1,1,0,356,356
1958,JMH0617,13,390,369,34,13,34,14,33,356,356
1959,JMH1847,347,348,45,369,48,11,44,14,302,21
1960,JMH2517,273,356,356,0,1,1,1,0,83,356
1961,JMM0848,470,200,8,388,10,1,8,2,462,188
1962,JMR3367,0,356,0,356,0,1,0,1,0,0
1963,JMS0149,0,356,0,356,0,1,0,1,0,0
1964,JMV0602,271,358,186,178,7,3,8,2,85,180
1965,JNC2650,0,356,200,156,0,1,1,1,200,200
1966,JNG1998,0,356,0,356,0,1,0,1,0,0
1967,JNM0905,0,356,14,342,0,1,1,1,14,14
1968,JNP1240,126,118,36,116,35,6,36,4,90,2
1969,JNR1694,0,356,0,356,0,1,0,1,0,0
1970,JNR2260,0,356,0,356,0,1,0,1,0,0
1971,JNS3342,347,381,63,384,65,25,61,28,284,3
1972,JNW2037,74,374,438,10,73,19,82,10,364,364
1973,JOA0305,299,361,378,2,19,6,22,2,79,359
1974,JOB1328,0,356,356,0,0,1,1,0,356,356
1975,JOC3621,290,545,373,104,15,5,17,3,83,441
1976,JON0788,50,214,55,209,50,19,55,14,5,5
1977,JOR2627,0,356,182,174,0,1,1,1,182,182
1978,JOW0688,0,356,356,0,0,1,1,0,356,356
1979,JPC2507,117,209,141,53,20,14,20,14,24,156
1980,JPF1296,0,356,186,170,0,1,1,1,186,186
1981,JPH1129,313,359,399,2,41,4,42,2,86,357
1982,JPJ0227,526,177,58,365,58,8,56,10,468,188
1983,JPS2432,108,1324,285,1148,105,870,105,871,177,176
1984,JQS2908,0,356,187,169,0,1,1,1,187,187
1985,JRA0522,0,356,356,0,0,1,1,0,356,356
1986,JRB0025,192,164,184,172,1,1,1,1,8,8
1987,JRB1080,286,356,0,356,1,1,0,1,286,0
1988,JRB2741,276,356,0,356,1,1,0,1,276,0
1989,JRF3424,0,356,64,292,0,1,1,1,64,64
1990,JRJ0919,259,335,182,153,1,1,1,1,77,182
1991,JRK2707,1,355,356,0,1,1,1,0,355,355
1992,JRL2365,0,356,0,356,0,1,0,1,0,0
1993,JRM0871,0,291,291,0,0,1,1,0,291,291
1994,JRM1303,0,356,184,172,0,1,1,1,184,184
1995,JRM2358,0,356,0,356,0,1,0,1,0,0
1996,JRP0250,0,356,0,356,0,1,0,1,0,0
1997,JRR0459,431,1356,150,1361,146,885,138,889,281,5
1998,JRR0769,65,366,426,5,59,10,65,5,361,361
1999,JRR0829,175,234,0,234,1,1,0,1,175,0
2000,JRR2745,283,363,14,362,13,8,13,7,269,1
2001,JRR3014,473,162,0,356,1,1,0,1,473,194
2002,JSB0320,289,356,0,356,1,1,0,1,289,0
2003,JSB0783,92,391,93,390,79,32,83,31,1,1
2004,JSB1535,0,356,0,356,0,1,0,1,0,0
2005,JSB2942,195,161,0,356,1,1,0,1,195,195
2006,JSC3976,102,132,0,132,1,1,0,1,102,0
2007,JSG3377,0,356,0,356,0,1,0,1,0,0
2008,JSH0887,0,356,0,356,0,1,0,1,0,0
2009,JSH1070,0,204,0,204,0,1,0,1,0,0
2010,JSH1843,401,318,41,377,38,13,40,10,360,59
2011,JSH3019,295,510,0,445,1,1,0,1,295,65
2012,JSJ2743,280,356,0,356,1,1,0,1,280,0
2013,JSM3334,0,356,0,356,0,1,0,1,0,0
2014,JSM3633,0,356,0,356,0,1,0,1,0,0
2015,JSM3931,0,356,188,168,0,1,1,1,188,188
2016,JSN0214,295,350,43,345,36,22,40,17,252,5
2017,JSN1905,356,0,0,356,1,0,0,1,356,356
2018,JSO3292,364,395,90,394,81,37,82,35,274,1
2019,JSR1085,275,355,0,356,1,1,0,1,275,1
2020,JSR3988,0,356,0,356,0,1,0,1,0,0
2021,JSW0872,275,357,6,357,7,2,6,2,269,0
2022,JTC0941,0,356,356,0,0,1,1,0,356,356
2023,JTH0719,0,356,0,356,0,1,0,1,0,0
2024,JTJ0597,307,408,15,407,17,4,15,5,292,1
2025,JTJ3700,0,419,356,63,0,1,1,1,356,356
2026,JTM0878,0,356,0,356,0,1,0,1,0,0
2027,JTN2073,322,377,239,190,48,6,47,7,83,187
2028,JTR3205,0,356,356,0,0,1,1,0,356,356
2029,JTS2090,0,356,0,356,0,1,0,1,0,0
2030,JTV1040,0,356,0,356,0,1,0,1,0,0
2031,JTV2654,274,356,198,158,1,1,1,1,76,198
2032,JUG0498,0,30,0,30,0,1,0,1,0,0
2033,JUH3378,0,356,0,356,0,1,0,1,0,0
2034,JUL1835,0,356,0,356,0,1,0,1,0,0
2035,JUM0102,0,356,356,0,0,1,1,0,356,356
2036,JVB3184,61,198,59,200,58,8,57,10,2,2
2037,JVC2443,139,521,104,453,37,369,36,370,35,68
2038,JVS2308,296,362,388,2,28,5,31,2,92,360
2039,JVZ3437,0,356,0,356,0,1,0,1,0,0
2040,JWB1519,0,356,356,0,0,1,1,0,356,356
2041,JWM0484,275,427,350,55,16,7,17,6,75,372
2042,JWW2765,0,356,356,0,0,1,1,0,356,356
2043,JXP3801,0,356,0,356,0,1,0,1,0,0
2044,JYB0262,7,449,7,449,7,26,7,26,0,0
2045,JYM3047,95,1317,89,1323,93,856,87,862,6,6
2046,JYW1965,42,314,0,356,1,1,0,1,42,42
2047,JZE2902,149,243,7,216,10,3,7,5,142,27
2048,JZM1335,0,356,356,0,0,1,1,0,356,356
2049,JZM1351,0,356,356,0,0,1,1,0,356,356
2050,KAA2150,0,356,356,0,0,1,1,0,356,356
2051,KAA2259,0,356,0,356,0,1,0,1,0,0
2052,KAB1420,0,356,0,356,0,1,0,1,0,0
2053,KAC0579,0,356,0,356,0,1,0,1,0,0
2054,KAC1774,358,1371,432,1018,79,893,76,893,74,353
2055,KAC2449,0,356,356,0,0,1,1,0,356,356
2056,KAD0884,0,356,0,356,0,1,0,1,0,0
2057,KAG0689,379,535,464,142,91,36,96,29,85,393
2058,KAG2599,363,380,92,377,81,24,83,22,271,3
2059,KAH1820,91,382,87,386,81,27,77,31,4,4
2060,KAH2398,0,356,0,356,0,1,0,1,0,0
2061,KAH2460,356,0,0,356,1,0,0,1,356,356
2062,KAH3247,286,356,0,356,1,1,0,1,286,0
2063,KAL1210,0,356,0,356,0,1,0,1,0,0
2064,KAM0005,0,356,0,356,0,1,0,1,0,0
2065,KAP0844,186,170,0,356,1,1,0,1,186,186
2066,KAP2430,81,1359,268,1172,80,893,78,894,187,187
2067,KAS2029,1,500,360,141,1,1,1,1,359,359
2068,KAV2926,5,382,197,190,5,1,6,1,192,192
2069,KAW3589,0,356,0,356,0,1,0,1,0,0
2070,KBA1020,0,356,0,356,0,1,0,1,0,0
2071,KBB0460,95,1343,92,1346,92,864,89,867,3,3
2072,KBB0890,0,356,0,356,0,1,0,1,0,0
2073,KBC0578,0,356,0,356,0,1,0,1,0,0
2074,KBC1485,118,141,150,17,26,7,26,7,32,124
2075,KBF2661,0,356,198,158,0,1,1,1,198,198
2076,KBG1117,21,554,20,556,21,53,20,54,1,2
2077,KBG2061,298,358,16,356,15,3,16,1,282,2
2078,KBH3913,298,360,366,4,11,5,11,4,68,356
2079,KBK3593,297,360,378,2,20,5,22,2,81,358
2080,KBM3460,78,365,81,362,68,10,70,7,3,3
2081,KBM3734,349,451,73,449,70,25,68,25,276,2
2082,KBO2485,355,0,24,332,1,0,1,1,331,332
2083,KBO2708,0,356,356,0,0,1,1,0,356,356
2084,KBP0384,347,547,279,284,65,29,72,21,68,263
2085,KBP0899,79,435,81,433,69,13,71,11,2,2
2086,KBP2753,0,356,0,356,0,1,0,1,0,0
2087,KBV1602,53,376,415,14,53,20,60,14,362,362
2088,KBW1629,0,355,356,0,0,1,1,0,356,355
2089,KCB1975,416,317,63,385,66,25,60,28,353,68
2090,KCC2434,86,1364,270,1180,83,880,79,884,184,184
2091,KCC3658,0,356,0,356,0,1,0,1,0,0
2092,KCD0181,0,356,189,167,0,1,1,1,189,189
2093,KCF0450,291,356,0,356,1,1,0,1,291,0
2094,KCG0979,108,373,471,10,91,17,97,10,363,363
2095,KCH2475,360,141,0,501,1,1,0,1,360,360
2096,KCH3095,331,375,250,180,57,16,60,13,81,195
2097,KCH3224,0,356,0,356,0,1,0,1,0,0
2098,KCL2310,297,448,381,50,21,6,22,5,84,398
2099,KCM0806,190,166,0,356,1,1,0,1,190,190
2100,KCM1858,0,428,356,72,0,1,1,1,356,356
2101,KCM1893,0,356,356,0,0,1,1,0,356,356
2102,KCM2495,0,356,0,356,0,1,0,1,0,0
2103,KCM3235,355,380,75,383,72,23,69,26,280,3
2104,KCO0269,190,166,0,356,1,1,0,1,190,190
2105,KCO0287,0,356,0,356,0,1,0,1,0,0
2106,KCO1253,0,387,43,344,0,1,1,1,43,43
2107,KCR0468,642,0,0,356,1,0,0,1,642,356
2108,KCR0577,277,356,0,356,1,1,0,1,277,0
2109,KCR2291,19,493,380,132,19,17,21,16,361,361
2110,KCS0605,270,356,176,180,1,1,1,1,94,176
2111,KCS3465,304,338,19,337,1,1,1,1,285,1
2112,KCT3965,0,356,0,356,0,1,0,1,0,0
2113,KCW2117,370,506,443,98,76,34,81,29,73,408
2114,KCW3064,295,360,377,1,19,5,22,1,82,359
2115,KDA1452,197,159,0,356,1,1,0,1,197,197
2116,KDB0266,5,351,0,356,1,1,0,1,5,5
2117,KDC0444,18,373,16,375,18,8,16,10,2,2
2118,KDC1487,0,356,356,0,0,1,1,0,356,356
2119,KDC2976,0,356,356,0,0,1,1,0,356,356
2120,KDF0876,0,356,0,356,0,1,0,1,0,0
2121,KDH1284,0,356,183,173,0,1,1,1,183,183
2122,KDM2836,0,356,197,159,0,1,1,1,197,197
2123,KDM3923,271,356,356,0,1,1,1,0,85,356
2124,KDN0264,0,356,0,356,0,1,0,1,0,0
2125,KDN1740,0,356,0,356,0,1,0,1,0,0
2126,KDR3234,0,428,0,428,0,1,0,1,0,0
2127,KDT1190,39,317,356,0,1,1,1,0,317,317
2128,KDT3290,286,364,3,365,5,9,3,10,283,1
2129,KDT3773,74,461,74,461,73,41,72,41,0,0
2130,KDW2929,342,396,256,205,61,9,63,9,86,191
2131,KEC0785,0,356,0,356,0,1,0,1,0,0
2132,KEC2465,356,0,0,356,1,0,0,1,356,356
2133,KED1219,0,66,0,66,0,1,0,1,0,0
2134,KEF0629,192,313,17,300,19,7,17,8,175,13
2135,KEF1057,371,1365,87,1368,88,821,84,826,284,3
2136,KEH0665,0,356,187,169,0,1,1,1,187,187
2137,KEM0113,0,356,356,0,0,1,1,0,356,356
2138,KEM1208,0,140,0,140,0,1,0,1,0,0
2139,KEM2934,194,162,0,356,1,1,0,1,194,194
2140,KEO0131,351,411,265,211,63,10,66,7,86,200
2141,KEW1179,0,356,0,356,0,1,0,1,0,0
2142,KEW2795,0,356,0,356,0,1,0,1,0,0
2143,KFB2257,0,45,0,45,0,1,0,1,0,0
2144,KFG2735,287,356,0,356,1,1,0,1,287,0
2145,KGB0500,0,356,0,356,0,1,0,1,0,0
2146,KGD2603,0,356,0,356,0,1,0,1,0,0
2147,KGD3278,0,356,0,356,0,1,0,1,0,0
2148,KGF2552,301,400,15,401,17,8,15,9,286,1
2149,KGN0619,272,356,356,0,1,1,1,0,84,356
2150,KGR2815,0,356,0,356,0,1,0,1,0,0
2151,KGS3466,0,356,0,356,0,1,0,1,0,0
2152,KHC2129,0,356,356,0,0,1,1,0,356,356
2153,KHC3350,0,356,0,356,0,1,0,1,0,0
2154,KHP1043,0,356,0,356,0,1,0,1,0,0
2155,KHW2052,0,356,0,356,0,1,0,1,0,0
2156,KIC1000,0,356,0,356,0,1,0,1,0,0
2157,KIC2314,290,358,17,358,16,3,15,3,273,0
2158,KIG1594,31,441,388,84,31,8,33,6,357,357
2159,KJB0354,697,61,59,423,58,9,52,15,638,362
2160,KJB3654,365,391,96,389,86,36,87,33,269,2
2161,KJC1419,96,378,97,377,87,23,87,22,1,1
2162,KJC3748,0,356,0,356,0,1,0,1,0,0
2163,KJD3392,555,174,72,376,68,19,65,21,483,202
2164,KJH0588,278,356,0,356,1,1,0,1,278,0
2165,KJP1326,0,176,176,0,0,1,1,0,176,176
2166,KJR1377,341,378,428,19,65,23,68,19,87,359
2167,KJR3538,0,356,356,0,0,1,1,0,356,356
2168,KJS0119,346,396,73,395,66,37,66,36,273,1
2169,KJS1940,349,614,420,153,55,39,60,35,71,461
2170,KKB1088,0,382,0,382,0,1,0,1,0,0
2171,KKB2094,0,356,0,356,0,1,0,1,0,0
2172,KKC2119,0,356,356,0,0,1,1,0,356,356
2173,KKD1980,425,2,66,361,67,2,65,6,359,359
2174,KKH2324,348,370,85,345,55,15,57,12,263,25
2175,KKL1310,0,356,191,165,0,1,1,1,191,191
2176,KKM0309,0,355,356,0,0,1,1,0,356,355
2177,KKM0624,9,357,10,356,9,2,10,1,1,1
2178,KKP2284,0,356,356,0,0,1,1,0,356,356
2179,KKS3790,35,321,0,356,1,1,0,1,35,35
2180,KLC3364,0,356,0,356,0,1,0,1,0,0
2181,KLD2255,0,226,0,226,0,1,0,1,0,0
2182,KLG0439,0,356,356,0,0,1,1,0,356,356
2183,KLH0276,269,356,0,356,1,1,0,1,269,0
2184,KLL3118,0,356,356,0,0,1,1,0,356,356
2185,KLM0714,0,356,0,356,0,1,0,1,0,0
2186,KLM1357,34,405,393,46,34,28,38,25,359,359
2187,KLM2448,0,356,356,0,0,1,1,0,356,356
2188,KLP0249,559,198,104,381,97,21,93,26,455,183
2189,KLP3864,5,425,357,73,1,1,1,1,352,352
2190,KLZ0507,0,356,0,356,0,1,0,1,0,0
2191,KMB1379,0,356,356,0,0,1,1,0,356,356
2192,KMB1761,115,1331,466,980,113,860,109,863,351,351
2193,KMB3003,0,356,182,174,0,1,1,1,182,182
2194,KMB3781,304,359,16,360,17,5,16,5,288,1
2195,KMC2028,0,355,356,0,0,1,1,0,356,355
2196,KMD3062,0,290,290,0,0,1,1,0,290,290
2197,KMR0373,58,363,416,5,56,8,59,5,358,358
2198,KMR0682,0,472,0,472,0,1,0,1,0,0
2199,KMR2232,276,356,356,0,1,1,1,0,80,356
2200,KMS0568,0,74,0,74,0,1,0,1,0,0
2201,KMS0954,17,338,356,0,1,1,1,0,339,338
2202,KMS1530,271,356,356,0,1,1,1,0,85,356
2203,KMW0259,0,356,0,356,0,1,0,1,0,0
2204,KMW1008,32,406,388,50,31,6,32,6,356,356
2205,KNA1279,0,354,189,167,0,1,1,1,189,187
2206,KNB0560,0,355,356,0,0,1,1,0,356,355
2207,KNC3843,0,356,0,356,0,1,0,1,0,0
2208,KND0529,281,356,356,0,1,1,1,0,75,356
2209,KNH0316,0,356,0,356,0,1,0,1,0,0
2210,KNH1985,356,0,0,356,1,0,0,1,356,356
2211,KNK1428,25,360,27,358,24,5,26,3,2,2
2212,KNL0918,0,356,188,168,0,1,1,1,188,188
2213,KNM0423,0,221,221,0,0,1,1,0,221,221
2214,KNM1154,302,612,8,528,9,48,8,48,294,84
2215,KNM1318,0,356,188,168,0,1,1,1,188,188
2216,KNM1674,0,356,0,356,0,1,0,1,0,0
2217,KNR3837,0,356,179,177,0,1,1,1,179,179
2218,KNS0539,0,356,356,0,0,1,1,0,356,356
2219,KNS2828,0,356,186,170,0,1,1,1,186,186
2220,KNS3380,0,356,0,356,0,1,0,1,0,0
2221,KNW1321,271,356,192,164,1,1,1,1,79,192
2222,KOB2624,0,356,181,175,0,1,1,1,181,181
2223,KOE0908,353,376,275,177,72,21,79,11,78,199
2224,KOE1033,0,356,0,356,0,1,0,1,0,0
2225,KOM1306,0,356,194,162,0,1,1,1,194,194
2226,KOP3802,0,356,0,356,0,1,0,1,0,0
2227,KOR1163,367,495,85,455,79,42,76,43,282,40
2228,KOW3756,2,360,2,360,2,5,2,5,0,0
2229,KPB1123,364,597,84,525,76,62,75,63,280,72
2230,KPN3783,0,356,0,356,0,1,0,1,0,0
2231,KPO3619,0,356,356,0,0,1,1,0,356,356
2232,KPP2253,0,356,0,356,0,1,0,1,0,0
2233,KPS0895,0,356,0,356,0,1,0,1,0,0
2234,KPS3882,282,581,0,484,1,1,0,1,282,97
2235,KQD0274,349,376,79,371,71,21,73,16,270,5
2236,KQW0164,356,0,0,356,1,0,0,1,356,356
2237,KRB3120,0,355,356,0,0,1,1,0,356,355
2238,KRC2935,260,78,48,168,48,9,46,11,212,90
2239,KRD2100,316,355,40,351,32,5,34,3,276,4
2240,KRH0589,0,356,0,356,0,1,0,1,0,0
2241,KRH1028,218,189,26,381,28,7,25,9,192,192
2242,KRL0467,116,1286,107,1295,105,833,100,837,9,9
2243,KRM3125,264,363,356,0,1,1,1,0,92,363
2244,KRN2211,0,356,0,356,0,1,0,1,0,0
2245,KSB1599,0,356,356,0,0,1,1,0,356,356
2246,KSD1646,270,360,0,356,1,1,0,1,270,4
2247,KSF0134,356,0,0,356,1,0,0,1,356,356
2248,KSH0672,0,356,186,170,0,1,1,1,186,186
2249,KSJ0840,183,173,0,356,1,1,0,1,183,183
2250,KSM1518,0,356,356,0,0,1,1,0,356,356
2251,KSM1772,89,1338,441,986,86,872,83,873,352,352
2252,KSN3347,0,243,0,243,0,1,0,1,0,0
2253,KSO2224,288,533,363,98,1,1,1,1,75,435
2254,KSP1288,28,361,215,174,26,6,30,3,187,187
2255,KSS2068,0,356,0,356,0,1,0,1,0,0
2256,KST0924,0,356,184,172,0,1,1,1,184,184
2257,KSV2881,34,322,0,356,1,1,0,1,34,34
2258,KSW0206,0,356,0,356,0,1,0,1,0,0
2259,KSW3237,279,356,0,356,1,1,0,1,279,0
2260,KTC0474,755,12,105,378,98,12,90,23,650,366
2261,KTD2249,288,362,375,3,16,7,19,3,87,359
2262,KTL2843,0,356,190,166,0,1,1,1,190,190
2263,KTL3785,25,331,0,356,1,1,0,1,25,25
2264,KTR3308,0,356,0,356,0,1,0,1,0,0
2265,KTS3908,0,259,259,0,0,1,1,0,259,259
2266,KTW1719,12,344,0,356,1,1,0,1,12,12
2267,KTW3547,0,356,0,356,0,1,0,1,0,0
2268,KUS2137,275,356,356,0,1,1,1,0,81,356
2269,KVA2944,190,166,0,356,1,1,0,1,190,190
2270,KVB3830,0,356,0,356,0,1,0,1,0,0
2271,KVD2453,0,356,356,0,0,1,1,0,356,356
2272,KVW0814,0,356,0,356,0,1,0,1,0,0
2273,KWB1967,46,310,0,356,1,1,0,1,46,46
2274,KWC3812,286,392,0,392,1,1,0,1,286,0
2275,KWD2589,0,356,0,356,0,1,0,1,0,0
2276,KWD3977,0,356,0,356,0,1,0,1,0,0
2277,KWR1544,0,356,55,301,0,1,1,1,55,55
2278,KZG3565,0,356,356,0,0,1,1,0,356,356
2279,KZK2058,0,356,0,356,0,1,0,1,0,0
2280,KZM2602,67,380,63,384,66,25,62,29,4,4
2281,LAB1297,0,356,187,169,0,1,1,1,187,187
2282,LAC0994,0,356,356,0,0,1,1,0,356,356
2283,LAE1350,0,356,356,0,0,1,1,0,356,356
2284,LAF1796,0,356,356,0,0,1,1,0,356,356
2285,LAF2213,349,709,55,615,56,37,52,39,294,94
2286,LAH0524,0,356,356,0,0,1,1,0,356,356
2287,LAH3026,273,344,356,1,14,4,16,1,83,343
2288,LAL1956,0,356,0,356,0,1,0,1,0,0
2289,LAN1329,93,207,124,49,1,1,1,1,31,158
2290,LAN2608,92,391,93,390,81,35,81,34,1,1
2291,LAO2771,0,356,356,0,0,1,1,0,356,356
2292,LAR0625,353,408,68,408,63,36,62,36,285,0
2293,LAS3757,0,356,0,356,0,1,0,1,0,0
2294,LAV1050,121,898,117,902,115,618,113,622,4,4
2295,LAW1407,0,356,0,356,0,1,0,1,0,0
2296,LBB0453,2,464,2,464,2,28,2,28,0,0
2297,LBC0194,0,356,0,356,0,1,0,1,0,0
2298,LBF1992,0,356,0,356,0,1,0,1,0,0
2299,LBG0407,104,287,389,2,27,1,27,1,285,285
2300,LBG1670,267,364,0,356,1,1,0,1,267,8
2301,LBG3911,0,356,356,0,0,1,1,0,356,356
2302,LBJ1723,287,356,356,0,1,1,1,0,69,356
2303,LBM0614,0,222,203,19,0,1,1,1,203,203
2304,LBM2142,0,356,356,0,0,1,1,0,356,356
2305,LBM3284,0,356,0,356,0,1,0,1,0,0
2306,LBR1387,0,356,356,0,0,1,1,0,356,356
2307,LBW3159,340,368,261,166,56,13,57,9,79,202
2308,LCB2041,0,356,356,0,0,1,1,0,356,356
2309,LCC1108,0,356,356,0,0,1,1,0,356,356
2310,LCC1963,313,637,34,522,33,25,31,26,279,115
2311,LCC2503,0,356,0,356,0,1,0,1,0,0
2312,LCF1216,10,370,12,368,10,15,12,13,2,2
2313,LCG0784,0,356,0,356,0,1,0,1,0,0
2314,LCH1789,0,356,0,356,0,1,0,1,0,0
2315,LCH2740,0,356,0,356,0,1,0,1,0,0
2316,LCK1403,278,356,15,341,1,1,1,1,263,15
2317,LCM1480,0,356,356,0,0,1,1,0,356,356
2318,LCP0344,299,429,2,400,1,1,1,1,297,29
2319,LCP0572,0,356,0,356,0,1,0,1,0,0
2320,LCR1537,0,356,0,356,0,1,0,1,0,0
2321,LCS3042,373,1338,96,1346,103,862,94,866,277,8
2322,LCT2783,0,69,0,69,0,1,0,1,0,0
2323,LCW0047,403,1305,95,1325,100,847,94,850,308,20
2324,LCW3879,0,356,0,356,0,1,0,1,0,0
2325,LDB3087,268,357,210,146,1,1,1,1,58,211
2326,LDB3304,284,540,0,465,1,1,0,1,284,75
2327,LDH0574,0,356,0,356,0,1,0,1,0,0
2328,LDN2514,381,406,462,39,89,21,99,10,81,367
2329,LDW0620,292,359,375,2,19,4,20,2,83,357
2330,LDW1472,0,76,76,0,0,1,1,0,76,76
2331,LEB1764,376,1346,465,993,111,875,107,876,89,353
2332,LEC3857,364,387,97,378,80,30,84,23,267,9
2333,LED0656,0,355,190,166,0,1,1,1,190,189
2334,LEM1913,356,0,0,356,1,0,0,1,356,356
2335,LEP2922,0,356,185,171,0,1,1,1,185,185
2336,LER3942,0,356,184,172,0,1,1,1,184,184
2337,LFB1624,291,356,356,0,1,1,1,0,65,356
2338,LFC2015,0,356,0,356,0,1,0,1,0,0
2339,LFF1887,0,356,356,0,0,1,1,0,356,356
2340,LFR0075,281,356,356,0,1,1,1,0,75,356
2341,LFS0392,0,356,356,0,0,1,1,0,356,356
2342,LGF1503,0,356,356,0,0,1,1,0,356,356
2343,LGJ2710,0,356,356,0,0,1,1,0,356,356
2344,LGL0649,0,356,185,171,0,1,1,1,185,185
2345,LGL2772,353,384,450,20,83,28,91,20,97,364
2346,LGM1260,0,356,0,356,0,1,0,1,0,0
2347,LGM2170,0,356,356,0,0,1,1,0,356,356
2348,LGR1036,0,356,0,356,0,1,0,1,0,0
2349,LGR3119,304,364,393,5,33,9,36,5,89,359
2350,LGS1812,0,356,0,356,0,1,0,1,0,0
2351,LGS1976,15,390,14,391,14,35,13,36,1,1
2352,LGS3477,0,356,0,356,0,1,0,1,0,0
2353,LHB3089,269,358,202,154,1,1,1,1,67,204
2354,LHG3145,0,356,202,154,0,1,1,1,202,202
2355,LHH2148,0,356,356,0,0,1,1,0,356,356
2356,LIC0203,323,367,400,7,41,12,45,7,77,360
2357,LIC3646,0,356,0,356,0,1,0,1,0,0
2358,LIG2813,30,368,33,365,29,13,32,10,3,3
2359,LIM1718,344,560,70,499,77,55,66,66,274,61
2360,LIW0379,0,356,181,175,0,1,1,1,181,181
2361,LJC0191,302,495,51,430,45,39,48,35,251,65
2362,LJC3980,0,356,0,356,0,1,0,1,0,0
2363,LJE2413,284,492,359,76,1,1,1,1,75,416
2364,LJH0866,0,356,356,0,0,1,1,0,356,356
2365,LJH2619,709,16,65,380,70,16,62,25,644,364
2366,LJM3339,0,144,0,144,0,1,0,1,0,0
2367,LJR0253,0,356,356,0,0,1,1,0,356,356
2368,LKB2322,0,356,5,351,0,1,1,1,5,5
2369,LKC1944,280,375,363,19,8,20,8,19,83,356
2370,LKF0335,0,30,0,30,0,1,0,1,0,0
2371,LKG0937,0,356,356,0,0,1,1,0,356,356
2372,LKH2512,285,357,356,0,1,1,1,0,71,357
2373,LKS1010,0,356,356,0,0,1,1,0,356,356
2374,LKS1416,374,381,98,385,93,24,90,29,276,4
2375,LLB3769,0,356,0,356,0,1,0,1,0,0
2376,LLG1238,0,356,0,356,0,1,0,1,0,0
2377,LLG2714,0,356,356,0,0,1,1,0,356,356
2378,LLG2958,182,174,0,356,1,1,0,1,182,182
2379,LLH3157,378,373,296,176,88,18,95,8,82,197
2380,LLJ1243,0,356,0,356,0,1,0,1,0,0
2381,LLJ3179,0,191,0,191,0,1,0,1,0,0
2382,LLS0222,0,356,356,0,0,1,1,0,356,356
2383,LLT0291,0,506,364,142,0,1,1,1,364,364
2384,LMA3676,0,356,0,356,0,1,0,1,0,0
2385,LMB1077,379,367,95,369,88,12,85,14,284,2
2386,LMB3241,0,356,0,356,0,1,0,1,0,0
2387,LMD2804,0,356,0,356,0,1,0,1,0,0
2388,LMF0670,0,356,181,175,0,1,1,1,181,181
2389,LMG1061,380,1306,88,1309,89,843,85,845,292,3
2390,LMH1987,356,0,0,356,1,0,0,1,356,356
2391,LMH2801,0,356,0,356,0,1,0,1,0,0
2392,LMH3831,277,356,0,356,1,1,0,1,277,0
2393,LMJ1783,0,356,0,356,0,1,0,1,0,0
2394,LMJ3535,0,356,356,0,0,1,1,0,356,356
2395,LMM3366,297,362,12,362,13,7,12,7,285,0
2396,LMS2868,276,356,190,166,1,1,1,1,86,190
2397,LMW2320,0,356,27,329,0,1,1,1,27,27
2398,LMZ1501,0,356,356,0,0,1,1,0,356,356
2399,LNA2543,0,356,0,356,0,1,0,1,0,0
2400,LNB2991,0,356,356,0,0,1,1,0,356,356
2401,LND2704,278,356,356,0,1,1,1,0,78,356
2402,LNK3345,300,360,20,360,21,5,20,5,280,0
2403,LNM1879,0,355,356,0,0,1,1,0,356,355
2404,LNP3092,271,357,193,163,1,1,1,1,78,194
2405,LNR0556,0,232,233,0,0,1,1,0,233,232
2406,LNV0271,85,73,0,158,1,1,0,1,85,85
2407,LOC0416,17,339,356,0,1,1,1,0,339,339
2408,LOC1446,180,176,0,356,1,1,0,1,180,180
2409,LOF3279,154,200,0,200,1,1,0,1,154,0
2410,LOP1055,111,1353,104,1360,105,856,99,861,7,7
2411,LOP1708,19,360,377,2,19,5,21,2,358,358
2412,LOR1044,41,163,10,163,11,120,10,120,31,0
2413,LPC2011,0,356,0,356,0,1,0,1,0,0
2414,LPE0270,203,153,0,356,1,1,0,1,203,203
2415,LPH3918,293,359,373,4,16,5,16,4,80,355
2416,LPW0767,0,356,356,0,0,1,1,0,356,356
2417,LQC3780,2,354,0,356,1,1,0,1,2,2
2418,LQJ3060,0,356,356,0,0,1,1,0,356,356
2419,LQW0555,2,354,0,356,1,1,0,1,2,2
2420,LQW1314,305,490,215,239,18,8,17,9,90,251
2421,LRB0372,0,356,356,0,0,1,1,0,356,356
2422,LRC3160,0,356,181,175,0,1,1,1,181,181
2423,LRF0101,0,356,356,0,0,1,1,0,356,356
2424,LRF1572,0,128,0,128,0,2,0,2,0,0
2425,LRG3408,191,165,0,356,1,1,0,1,191,191
2426,LRK2426,83,1325,265,1143,80,841,78,842,182,182
2427,LRL1316,271,356,194,162,1,1,1,1,77,194
2428,LRM1362,364,382,80,385,76,26,74,29,284,3
2429,LRM1922,290,359,366,2,10,4,11,2,76,357
2430,LRP2591,25,331,0,356,1,1,0,1,25,25
2431,LRS1165,0,356,0,356,0,1,0,1,0,0
2432,LRS1168,0,356,0,356,0,1,0,1,0,0
2433,LRS2996,325,372,40,375,41,8,37,11,285,3
2434,LRT0447,0,356,0,356,0,1,0,1,0,0
2435,LRU3765,0,356,0,356,0,1,0,1,0,0
2436,LRV1120,0,356,0,356,0,1,0,1,0,0
2437,LRW1502,0,356,356,0,0,1,1,0,356,356
2438,LSC3979,0,356,0,356,0,1,0,1,0,0
2439,LSL0001,340,389,65,390,61,34,60,35,275,1
2440,LSL0337,0,356,0,356,0,1,0,1,0,0
2441,LSM0408,0,356,356,0,0,1,1,0,356,356
2442,LSM2234,0,356,356,0,0,1,1,0,356,356
2443,LSN1672,293,639,17,526,15,24,16,21,276,113
2444,LTF3385,472,159,0,356,1,1,0,1,472,197
2445,LTH1795,16,360,372,4,16,5,17,4,356,356
2446,LTO2217,0,356,0,356,0,1,0,1,0,0
2447,LTR1729,0,356,356,0,0,1,1,0,356,356
2448,LTW1378,333,415,419,30,47,19,51,13,86,385
2449,LTW1441,0,392,0,392,0,1,0,1,0,0
2450,LUG2205,364,397,84,394,79,33,76,35,280,3
2451,LUK1182,2,373,2,373,2,18,2,18,0,0
2452,LVH1790,287,359,16,357,13,4,14,2,271,2
2453,LVK3180,161,192,17,183,9,2,10,1,144,9
2454,LWB2851,299,504,197,256,8,4,9,3,102,248
2455,LWH0180,0,356,187,169,0,1,1,1,187,187
2456,LWV1525,373,371,467,7,92,16,100,7,94,364
2457,LXC0839,530,202,72,384,68,24,63,28,458,182
2458,LXE2139,254,364,310,61,48,15,52,10,56,303
2459,LXG2919,0,356,177,179,0,1,1,1,177,177
2460,LXS0332,378,614,457,159,84,56,92,46,79,455
2461,LYB3419,55,369,68,356,52,8,56,5,13,13
2462,LYF3449,282,356,0,356,1,1,0,1,282,0
2463,LYS3814,362,390,80,388,73,21,73,21,282,2
2464,LZM0306,36,433,398,71,33,13,36,10,362,362
2465,MAB1775,109,1328,459,978,103,874,98,876,350,350
2466,MAC1404,0,356,0,356,0,1,0,1,0,0
2467,MAC2962,190,166,0,356,1,1,0,1,190,190
2468,MAC3214,39,382,399,22,37,26,42,22,360,360
2469,MAG2667,0,235,235,0,0,1,1,0,235,235
2470,MAH0438,293,356,356,0,1,1,1,0,63,356
2471,MAH0590,0,200,0,200,0,1,0,1,0,0
2472,MAH2095,390,372,104,376,99,17,95,21,286,4
2473,MAK1309,0,356,187,169,0,1,1,1,187,187
2474,MAL0434,0,356,188,168,0,1,1,1,188,188
2475,MAL2345,346,364,60,369,60,9,54,14,286,5
2476,MAM2363,0,248,0,248,0,1,0,1,0,0
2477,MAM2630,0,356,186,170,0,1,1,1,186,186
2478,MAP0215,0,356,0,356,0,1,0,1,0,0
2479,MAR2386,0,356,0,356,0,1,0,1,0,0
2480,MAS3218,243,337,9,338,10,4,9,5,234,1
2481,MAW0532,330,536,401,94,32,13,37,8,71,442
2482,MAY0978,0,356,356,0,0,1,1,0,356,356
2483,MBA1797,59,129,75,31,1,1,1,1,16,98
2484,MBA2092,283,356,0,356,1,1,0,1,283,0
2485,MBB2649,0,356,187,169,0,1,1,1,187,187
2486,MBC0803,465,166,0,356,1,1,0,1,465,190
2487,MBF3126,0,356,356,0,0,1,1,0,356,356
2488,MBG3183,297,357,75,307,15,13,14,14,222,50
2489,MBH0476,356,0,0,356,1,0,0,1,356,356
2490,MBH0527,297,613,374,174,12,7,13,6,77,439
2491,MBH1370,290,368,7,368,8,1,7,1,283,0
2492,MBH3427,372,372,97,363,81,16,88,7,275,9
2493,MBL1247,0,356,0,356,0,1,0,1,0,0
2494,MBL2383,0,356,0,356,0,1,0,1,0,0
2495,MBN3610,320,500,395,80,31,7,32,6,75,420
2496,MBP1728,0,356,0,356,0,1,0,1,0,0
2497,MBP1960,0,356,0,356,0,1,0,1,0,0
2498,MBR3261,0,356,356,0,0,1,1,0,356,356
2499,MBR3648,359,382,78,383,76,27,74,28,281,1
2500,MBS1375,377,372,469,12,95,17,98,12,92,360
2501,MBS3902,0,356,0,356,0,1,0,1,0,0
2502,MBW1099,0,356,356,0,0,1,1,0,356,356
2503,MCB0591,0,356,0,356,0,1,0,1,0,0
2504,MCB2802,270,356,0,356,1,1,0,1,270,0
2505,MCC0856,12,506,372,146,12,15,13,15,360,360
2506,MCF3187,0,356,356,0,0,1,1,0,356,356
2507,MCH3354,331,428,42,433,47,12,40,17,289,5
2508,MCJ3137,0,356,196,160,0,1,1,1,196,196
2509,MCK0435,312,577,204,297,17,13,17,13,108,280
2510,MCM2189,274,356,356,0,1,1,1,0,82,356
2511,MCM2375,0,355,193,163,0,1,1,1,193,192
2512,MCN0985,0,356,356,0,0,1,1,0,356,356
2513,MCO3164,305,357,210,174,27,2,27,2,95,183
2514,MCQ1546,0,356,22,334,0,1,1,1,22,22
2515,MCR3885,0,356,0,356,0,1,0,1,0,0
2516,MCS0512,0,356,0,356,0,1,0,1,0,0
2517,MCS1078,11,345,0,356,1,1,0,1,11,11
2518,MCS3301,0,356,0,356,0,1,0,1,0,0
2519,MCT0424,0,356,356,0,0,1,1,0,356,356
2520,MCT1067,0,356,0,356,0,1,0,1,0,0
2521,MCW0674,11,408,215,204,11,3,13,2,204,204
2522,MCW2546,0,356,0,356,0,1,0,1,0,0
2523,MCW3493,0,356,0,356,0,1,0,1,0,0
2524,MCY0601,0,356,197,159,0,1,1,1,197,197
2525,MDB0680,0,356,0,356,0,1,0,1,0,0
2526,MDD1920,0,356,356,0,0,1,1,0,356,356
2527,MDE2114,317,409,383,51,25,10,27,8,66,358
2528,MDF1222,306,363,30,364,30,8,28,9,276,1
2529,MDG0019,0,356,356,0,0,1,1,0,356,356
2530,MDG0657,0,356,189,167,0,1,1,1,189,189
2531,MDG2418,285,412,372,52,13,7,17,3,87,360
2532,MDG3281,0,356,0,356,0,1,0,1,0,0
2533,MDH0211,0,356,0,356,0,1,0,1,0,0
2534,MDH1924,0,356,356,0,0,1,1,0,356,356
2535,MDH2713,0,356,356,0,0,1,1,0,356,356
2536,MDH3639,0,356,0,356,0,1,0,1,0,0
2537,MDM2496,10,346,0,356,1,1,0,1,10,10
2538,MDM3580,0,455,0,455,0,1,0,1,0,0
2539,MDO0606,295,435,210,250,25,3,25,2,85,185
2540,MDP0161,281,356,0,356,1,1,0,1,281,0
2541,MDP1412,0,356,0,356,0,1,0,1,0,0
2542,MDS0285,0,356,356,0,0,1,1,0,356,356
2543,MDS0759,475,155,0,356,1,1,0,1,475,201
2544,MEA3886,91,385,87,389,81,28,80,32,4,4
2545,MEB2241,274,356,356,0,1,1,1,0,82,356
2546,MEB3004,0,356,1,355,0,1,1,1,1,1
2547,MEC0781,275,449,350,98,60,28,64,24,75,351
2548,MEM1745,0,356,175,181,0,1,1,1,175,175
2549,MET1881,297,398,375,23,12,10,14,8,78,375
2550,MEV2182,0,203,203,0,0,1,1,0,203,203
2551,MEW1406,287,370,10,363,4,15,3,16,277,7
2552,MFB0040,0,356,0,356,0,1,0,1,0,0
2553,MFD2890,362,270,9,347,1,1,1,1,353,77
2554,MFK0902,9,460,6,463,9,3,6,6,3,3
2555,MFL0355,5,351,0,356,1,1,0,1,5,5
2556,MFW0646,0,356,192,164,0,1,1,1,192,192
2557,MGB0326,0,356,2,354,0,1,1,1,2,2
2558,MGG0080,3,432,3,432,3,24,3,24,0,0
2559,MGG1756,292,360,205,173,18,5,20,3,87,187
2560,MGM0569,321,364,35,365,35,9,32,10,286,1
2561,MGS2159,0,356,356,0,0,1,1,0,356,356
2562,MHA0667,0,355,195,161,0,1,1,1,195,194
2563,MHB0845,195,161,0,356,1,1,0,1,195,195
2564,MHG3749,58,406,50,414,57,51,49,59,8,8
2565,MHH0034,0,356,0,356,0,1,0,1,0,0
2566,MHH2192,0,356,356,0,0,1,1,0,356,356
2567,MHM2370,0,356,0,356,0,1,0,1,0,0
2568,MHR0581,57,373,59,371,55,17,57,15,2,2
2569,MHS0125,0,356,0,356,0,1,0,1,0,0
2570,MHS1125,0,356,356,0,0,1,1,0,356,356
2571,MHS1146,0,355,356,0,0,1,1,0,356,355
2572,MHS2634,301,358,213,162,18,3,18,3,88,196
2573,MHV1529,0,356,356,0,0,1,1,0,356,356
2574,MIA0939,0,356,356,0,0,1,1,0,356,356
2575,MIA3825,279,366,0,364,1,1,0,1,279,2
2576,MIC2325,0,356,24,332,0,1,1,1,24,24
2577,MJA2380,287,592,362,129,1,1,1,1,75,463
2578,MJB2167,0,356,356,0,0,1,1,0,356,356
2579,MJB3866,0,356,356,0,0,1,1,0,356,356
2580,MJC1471,269,356,356,0,1,1,1,0,87,356
2581,MJD0469,356,0,0,356,1,0,0,1,356,356
2582,MJF0334,0,355,0,356,0,1,0,1,0,1
2583,MJG2304,357,372,450,4,74,17,83,4,93,368
2584,MJH3822,0,356,0,356,0,1,0,1,0,0
2585,MJK0037,307,362,25,360,25,4,25,3,282,2
2586,MJM3657,296,364,13,365,15,9,13,10,283,1
2587,MJP2421,0,356,356,0,0,1,1,0,356,356
2588,MJR0244,190,166,0,356,1,1,0,1,190,190
2589,MJS0832,0,356,0,356,0,1,0,1,0,0
2590,MJS1251,0,356,0,356,0,1,0,1,0,0
2591,MJS3720,28,30,5,30,6,3,5,3,23,0
2592,MJW2032,22,24,27,0,4,1,4,0,5,24
2593,MKC1094,0,356,356,0,0,1,1,0,356,356
2594,MKC2767,279,382,356,26,1,1,1,1,77,356
2595,MKD1004,0,356,185,171,0,1,1,1,185,185
2596,MKH1959,0,356,0,356,0,1,0,1,0,0
2597,MKJ1574,302,364,25,365,26,9,24,10,277,1
2598,MKM0647,305,367,211,177,22,12,19,15,94,190
2599,MKM1993,287,356,0,356,1,1,0,1,287,0
2600,MKN3375,0,356,0,356,0,1,0,1,0,0
2601,MKO0749,0,356,356,0,0,1,1,0,356,356
2602,MKR1339,359,369,438,8,73,14,75,8,79,361
2603,MKR2138,0,436,365,71,0,1,1,1,365,365
2604,MKR2258,0,356,0,356,0,1,0,1,0,0
2605,MKW0157,0,356,356,0,0,1,1,0,356,356
2606,MLB1214,0,140,0,140,0,1,0,1,0,0
2607,MLC3482,362,363,439,1,73,8,78,1,77,362
2608,MLF2319,0,356,4,352,0,1,1,1,4,4
2609,MLG2305,0,356,356,0,0,1,1,0,356,356
2610,MLJ1461,492,173,22,361,21,6,20,6,470,188
2611,MLM2021,48,60,0,60,1,1,0,1,48,0
2612,MLP3859,0,356,0,356,0,1,0,1,0,0
2613,MLS2856,276,355,191,165,1,1,1,1,85,190
2614,MLV0088,0,356,0,356,0,1,0,1,0,0
2615,MLV3376,296,362,15,364,18,7,14,9,281,2
2616,MLW0296,0,356,356,0,0,1,1,0,356,356
2617,MLW2240,292,511,360,86,1,1,1,1,68,425
2618,MMA1255,0,356,0,356,0,1,0,1,0,0
2619,MMB0185,0,356,190,166,0,1,1,1,190,190
2620,MMB2285,0,356,356,0,0,1,1,0,356,356
2621,MMC0261,58,81,0,81,1,8,0,8,58,0
2622,MMC1084,95,290,28,357,29,1,27,2,67,67
2623,MMD2022,0,356,0,356,0,1,0,1,0,0
2624,MME3399,462,163,0,356,1,1,0,1,462,193
2625,MMH2878,0,356,0,356,0,1,0,1,0,0
2626,MMJ0070,374,392,91,389,82,33,81,34,283,3
2627,MMJ3368,0,356,0,356,0,1,0,1,0,0
2628,MML2045,0,356,0,356,0,1,0,1,0,0
2629,MMM2156,0,356,356,0,0,1,1,0,356,356
2630,MMR0700,0,356,356,0,0,1,1,0,356,356
2631,MMR1435,6,453,5,454,6,23,5,24,1,1
2632,MMR1695,279,609,0,498,1,1,0,1,279,111
2633,MMR1864,298,379,383,23,28,23,28,22,85,356
2634,MMS0241,509,337,19,461,19,10,19,9,490,124
2635,MMW1927,286,357,372,0,16,2,17,0,86,357
2636,MNB2570,0,356,0,356,0,1,0,1,0,0
2637,MNB3094,270,358,199,157,1,1,1,1,71,201
2638,MNC0433,0,356,195,161,0,1,1,1,195,195
2639,MNC3485,22,334,0,356,1,1,0,1,22,22
2640,MND1058,34,602,33,603,34,421,33,422,1,1
2641,MNG3693,298,344,375,0,20,1,20,0,77,344
2642,MNM1161,0,356,0,356,0,1,0,1,0,0
2643,MNM2369,279,390,0,378,1,1,0,1,279,12
2644,MNN1167,0,356,0,356,0,1,0,1,0,0
2645,MNP0290,0,356,356,0,0,1,1,0,356,356
2646,MNP0955,0,356,356,0,0,1,1,0,356,356
2647,MNR1903,741,7,103,371,93,7,88,16,638,364
2648,MNS1394,276,356,0,356,1,1,0,1,276,0
2649,MNT0922,349,443,261,248,62,12,65,9,88,195
2650,MNV0618,277,356,356,0,1,1,1,0,79,356
2651,MNW1733,38,373,33,378,34,16,30,22,5,5
2652,MNW1827,0,356,0,356,0,1,0,1,0,0
2653,MNW2267,288,363,22,364,24,8,22,9,266,1
2654,MOB1914,356,0,0,356,1,0,0,1,356,356
2655,MOS0496,284,356,0,356,1,1,0,1,284,0
2656,MOW1104,275,356,356,0,1,1,1,0,81,356
2657,MPB2578,0,434,0,434,0,1,0,1,0,0
2658,MPG1307,0,356,198,158,0,1,1,1,198,198
2659,MPH0153,0,525,187,339,0,1,1,1,187,186
2660,MPS2849,0,423,180,243,0,1,1,1,180,180
2661,MPY0478,0,356,356,0,0,1,1,0,356,356
2662,MQM1638,276,356,356,0,1,1,1,0,80,356
2663,MQR1657,359,431,85,427,77,39,75,41,274,4
2664,MQS3541,0,39,0,39,0,1,0,1,0,0
2665,MRB0796,0,356,0,356,0,1,0,1,0,0
2666,MRB2390,0,356,356,0,0,1,1,0,356,356
2667,MRC2160,0,356,356,0,0,1,1,0,356,356
2668,MRE0567,285,356,0,356,1,1,0,1,285,0
2669,MRE3723,0,356,0,356,0,1,0,1,0,0
2670,MRH2516,0,360,356,4,0,1,1,1,356,356
2671,MRH2722,0,229,229,0,0,1,1,0,229,229
2672,MRL2636,286,356,189,167,1,1,1,1,97,189
2673,MRM2906,0,356,187,169,0,1,1,1,187,187
2674,MRS0368,0,356,356,0,0,1,1,0,356,356
2675,MRS0409,71,313,384,0,26,3,28,0,313,313
2676,MRS1520,0,356,356,0,0,1,1,0,356,356
2677,MRT1855,0,356,356,0,0,1,1,0,356,356
2678,MRW2504,0,356,356,0,0,1,1,0,356,356
2679,MRW3143,0,356,195,161,0,1,1,1,195,195
2680,MSB0830,0,356,0,356,0,1,0,1,0,0
2681,MSB2786,0,356,0,356,0,1,0,1,0,0
2682,MSF3311,0,356,0,356,0,1,0,1,0,0
2683,MSH1269,0,356,189,167,0,1,1,1,189,189
2684,MSH2210,0,356,0,356,0,1,0,1,0,0
2685,MSM3264,0,356,356,0,0,1,1,0,356,356
2686,MSP3845,327,373,49,374,51,17,49,19,278,1
2687,MSR2202,0,356,356,0,0,1,1,0,356,356
2688,MSR2850,306,331,233,177,72,20,79,11,73,154
2689,MSR3709,305,331,356,0,1,1,1,0,51,331
2690,MSS3335,0,356,1,355,0,1,1,1,1,1
2691,MST2486,479,1,120,360,109,1,105,5,359,359
2692,MSW0973,0,356,356,0,0,1,1,0,356,356
2693,MTB2982,0,356,356,0,0,1,1,0,356,356
2694,MTC0855,284,357,374,0,18,2,19,0,90,357
2695,MTG0463,101,1359,88,1372,91,883,84,888,13,13
2696,MTL3695,0,356,356,0,0,1,1,0,356,356
2697,MTM1434,0,356,0,356,0,1,0,1,0,0
2698,MTN1330,0,356,356,0,0,1,1,0,356,356
2699,MTP2675,306,364,398,2,36,9,42,2,92,362
2700,MTS0465,106,1715,100,1721,104,1045,98,1048,6,6
2701,MTW3317,0,356,0,356,0,1,0,1,0,0
2702,MUH3099,0,356,187,169,0,1,1,1,187,187
2703,MUO3601,278,356,356,0,1,1,1,0,78,356
2704,MVA2547,296,381,11,381,12,7,11,7,285,0
2705,MVA3761,0,356,0,356,0,1,0,1,0,0
2706,MVB3343,0,356,0,356,0,1,0,1,0,0
2707,MVO2746,368,391,88,389,78,35,77,34,280,2
2708,MVS1908,356,0,0,356,1,0,0,1,356,356
2709,MVW3821,0,356,0,356,0,1,0,1,0,0
2710,MWB0710,0,356,356,0,0,1,1,0,356,356
2711,MWB4000,0,356,0,356,0,1,0,1,0,0
2712,MWG1570,280,542,0,466,1,1,0,1,280,76
2713,MWH0347,0,45,0,45,0,1,0,1,0,0
2714,MWH1018,0,356,356,0,0,1,1,0,356,356
2715,MWK3854,0,356,0,356,0,1,0,1,0,0
2716,MWO0559,190,245,245,0,1,1,1,0,55,245
2717,MXG0821,0,356,0,356,0,1,0,1,0,0
2718,MXR3432,278,356,0,356,1,1,0,1,278,0
2719,MYB3817,280,356,0,356,1,1,0,1,280,0
2720,MYW0914,0,65,31,34,0,1,1,1,31,31
2721,MZG2261,0,356,0,356,0,1,0,1,0,0
2722,NAH3759,289,359,15,361,18,4,15,6,274,2
2723,NAK2784,0,356,0,356,0,1,0,1,0,0
2724,NAR1527,272,363,356,7,1,1,1,1,84,356
2725,NBC0607,0,356,190,166,0,1,1,1,190,190
2726,NBD2469,356,0,0,356,1,0,0,1,356,356
2727,NBF3844,0,356,0,356,0,1,0,1,0,0
2728,NBH3076,0,356,0,356,0,1,0,1,0,0
2729,NBL0182,278,356,192,164,1,1,1,1,86,192
2730,NBL2243,0,356,356,0,0,1,1,0,356,356
2731,NBN2651,0,356,178,178,0,1,1,1,178,178
2732,NBP0217,70,406,62,414,66,29,58,37,8,8
2733,NBR1873,0,355,356,0,0,1,1,0,356,355
2734,NBR3731,6,489,5,490,6,30,5,31,1,1
2735,NBT3447,309,636,29,532,33,38,29,41,280,104
2736,NBW2810,72,375,66,381,65,20,60,26,6,6
2737,NCA3027,0,356,356,0,0,1,1,0,356,356
2738,NCB2660,0,356,192,164,0,1,1,1,192,192
2739,NCM3725,0,356,0,356,0,1,0,1,0,0
2740,NCO1443,1,355,0,356,1,1,0,1,1,1
2741,NCR2854,356,363,256,174,60,8,61,7,100,189
2742,NCS0425,0,356,356,0,0,1,1,0,356,356
2743,NCS1854,337,437,414,76,47,15,52,10,77,361
2744,NCS3577,0,356,0,356,0,1,0,1,0,0
2745,NCS3715,0,356,0,356,0,1,0,1,0,0
2746,NCT0983,0,356,356,0,0,1,1,0,356,356
2747,NCT3492,0,356,0,356,0,1,0,1,0,0
2748,NCV0758,37,37,0,74,1,1,0,1,37,37
2749,NDA0536,0,356,356,0,0,1,1,0,356,356
2750,NDB0517,7,372,7,372,7,17,7,17,0,0
2751,NDC0948,455,276,458,1,92,7,96,1,3,275
2752,NDG3403,190,166,0,356,1,1,0,1,190,190
2753,NDH3827,0,356,0,356,0,1,0,1,0,0
2754,NDK3436,47,465,50,462,44,16,47,13,3,3
2755,NDM2251,25,35,37,0,3,1,3,0,12,35
2756,NDR1456,187,169,0,356,1,1,0,1,187,187
2757,NDS1897,0,297,297,0,0,1,1,0,297,297
2758,NDW1863,277,467,357,60,1,1,1,1,80,407
2759,NDW3217,291,392,16,394,19,37,16,39,275,2
2760,NEA3248,0,356,0,356,0,1,0,1,0,0
2761,NEB0371,0,356,356,0,0,1,1,0,356,356
2762,NEB3445,236,289,20,291,23,5,20,7,216,2
2763,NEC2033,0,356,356,0,0,1,1,0,356,356
2764,NEC2446,0,356,356,0,0,1,1,0,356,356
2765,NEE1632,359,373,441,11,71,17,77,10,82,362
2766,NEH1185,0,245,245,0,0,1,1,0,245,245
2767,NEH3435,361,385,86,382,77,14,79,11,275,3
2768,NEW2490,0,356,0,356,0,1,0,1,0,0
2769,NFP2441,362,1337,280,1152,93,848,86,852,82,185
2770,NGA0929,0,356,356,0,0,1,1,0,356,356
2771,NGB0066,453,9,92,370,87,9,82,15,361,361
2772,NGC1617,0,356,356,0,0,1,1,0,356,356
2773,NGH1256,0,355,2,354,0,1,1,1,2,1
2774,NGP0549,5,351,0,356,1,1,0,1,5,5
2775,NGR2884,129,288,49,368,53,7,46,13,80,80
2776,NGS2820,0,288,0,288,0,1,0,1,0,0
2777,NGV3638,97,123,0,123,1,1,0,1,97,0
2778,NGW2341,275,356,61,295,1,1,1,1,214,61
2779,NHD2497,277,356,0,356,1,1,0,1,277,0
2780,NHE3204,0,218,218,0,0,1,1,0,218,218
2781,NHG3810,0,356,0,356,0,1,0,1,0,0
2782,NHH1704,0,356,0,356,0,1,0,1,0,0
2783,NHH3276,0,114,0,114,0,1,0,1,0,0
2784,NHK2846,14,463,197,280,14,20,13,22,183,183
2785,NHM1805,336,385,428,15,56,27,69,15,92,370
2786,NHN0711,0,45,45,0,0,1,1,0,45,45
2787,NHP0412,398,362,481,2,105,7,107,2,83,360
2788,NHR1220,0,355,0,356,0,1,0,1,0,1
2789,NHR2050,0,356,0,356,0,1,0,1,0,0
2790,NHS3981,0,356,8,348,0,1,1,1,8,8
2791,NHV2004,184,235,20,233,19,7,18,5,164,2
2792,NHW0864,0,356,356,0,0,1,1,0,356,356
2793,NHY0685,0,356,356,0,0,1,1,0,356,356
2794,NIB1197,21,362,380,3,21,7,25,3,359,359
2795,NIM0052,0,356,356,0,0,1,1,0,356,356
2796,NIM1630,0,356,356,0,0,1,1,0,356,356
2797,NIR3139,280,356,190,166,1,1,1,1,90,190
2798,NIR3987,292,449,23,449,23,20,19,24,269,0
2799,NIW3071,335,362,51,365,51,7,47,9,284,3
2800,NJC1951,0,356,3,353,0,1,1,1,3,3
2801,NJG2979,0,356,356,0,0,1,1,0,356,356
2802,NJG3144,0,51,25,26,0,1,1,1,25,25
2803,NJH0196,0,356,356,0,0,1,1,0,356,356
2804,NJL0974,199,259,250,11,3,12,3,11,51,248
2805,NJL2478,636,0,0,356,1,0,0,1,636,356
2806,NJM0173,283,415,356,60,1,1,1,1,73,355
2807,NJM0440,374,374,451,8,75,17,82,8,77,366
2808,NJM3961,0,356,0,356,0,1,0,1,0,0
2809,NJO1460,183,173,0,356,1,1,0,1,183,183
2810,NJP1439,4,352,0,356,1,1,0,1,4,4
2811,NJR1714,0,356,356,0,0,1,1,0,356,356
2812,NJS2473,356,0,0,356,1,0,0,1,356,356
2813,NJS2498,0,424,0,424,0,1,0,1,0,0
2814,NJS2657,0,356,183,173,0,1,1,1,183,183
2815,NJW2402,0,376,180,196,0,1,1,1,180,180
2816,NKC3652,0,267,0,267,0,1,0,1,0,0
2817,NKD3073,364,373,87,372,77,18,77,17,277,1
2818,NKG2706,0,356,356,0,0,1,1,0,356,356
2819,NKM2195,297,362,383,3,25,7,28,3,86,359
2820,NKN3153,0,356,183,173,0,1,1,1,183,183
2821,NKV1451,189,167,0,356,1,1,0,1,189,189
2822,NLC2601,356,369,70,372,64,14,62,17,286,3
2823,NLN0513,0,356,0,356,0,1,0,1,0,0
2824,NLN0673,0,356,186,170,0,1,1,1,186,186
2825,NLP0155,0,356,180,176,0,1,1,1,180,180
2826,NLS1866,0,356,356,0,0,1,1,0,356,356
2827,NMC3998,282,362,8,363,10,7,8,8,274,1
2828,NMM1560,346,426,63,422,63,53,61,55,283,4
2829,NMM1844,1,160,0,161,1,1,0,1,1,1
2830,NMP3872,0,356,356,0,0,1,1,0,356,356
2831,NMR2725,280,358,0,356,1,1,0,1,280,2
2832,NMS1493,0,356,356,0,0,1,1,0,356,356
2833,NMV2556,0,356,0,356,0,1,0,1,0,0
2834,NMW0896,0,356,33,323,0,1,1,1,33,33
2835,NNB2730,0,356,0,356,0,1,0,1,0,0
2836,NNB3989,0,356,68,288,0,1,1,1,68,68
2837,NNF3968,347,398,71,395,67,42,67,39,276,3
2838,NNJ1215,0,355,0,356,0,1,0,1,0,1
2839,NNJ2986,0,356,356,0,0,1,1,0,356,356
2840,NNM2862,354,614,259,322,62,36,67,32,95,292
2841,NNP0229,82,294,18,358,20,2,18,3,64,64
2842,NOD1261,0,152,0,152,0,1,0,1,0,0
2843,NOE2965,279,354,356,0,1,1,1,0,77,354
2844,NPK0369,0,356,0,356,0,1,0,1,0,0
2845,NPR1612,104,128,128,0,1,1,1,0,24,128
2846,NPS1563,0,356,0,356,0,1,0,1,0,0
2847,NQM0084,357,380,78,388,84,23,75,33,279,8
2848,NQO2712,318,366,393,7,35,11,37,7,75,359
2849,NRE1755,266,356,190,166,1,1,1,1,76,190
2850,NRG1562,270,362,0,362,1,1,0,1,270,0
2851,NRK3448,322,521,25,458,28,7,25,10,297,63
2852,NRN1312,372,561,292,288,77,50,85,42,80,273
2853,NRN2936,71,62,0,133,1,1,0,1,71,71
2854,NRT1320,280,466,178,237,1,1,1,1,102,229
2855,NSB1016,0,356,356,0,0,1,1,0,356,356
2856,NSC0237,284,356,356,0,1,1,1,0,72,356
2857,NSC1741,0,355,0,356,0,1,0,1,0,1
2858,NSC1939,285,356,356,0,1,1,1,0,71,356
2859,NSC3036,96,1309,95,1310,94,840,94,840,1,1
2860,NSE3944,0,355,189,167,0,1,1,1,189,188
2861,NSM1464,21,358,377,2,20,3,21,2,356,356
2862,NSM2805,0,417,0,417,0,1,0,1,0,0
2863,NSR2539,0,538,0,538,0,3,0,3,0,0
2864,NSW0122,0,356,0,356,0,1,0,1,0,0
2865,NSW3199,0,356,356,0,0,1,1,0,356,356
2866,NTC2663,22,369,213,178,21,14,22,14,191,191
2867,NTE3084,0,356,0,356,0,1,0,1,0,0
2868,NTF1342,301,359,377,2,19,4,20,2,76,357
2869,NTH2822,0,356,0,356,0,1,0,1,0,0
2870,NTP2146,16,390,374,32,16,35,19,32,358,358
2871,NUK1513,35,367,395,7,35,12,39,7,360,360
2872,NVH3726,339,393,64,387,56,33,59,30,275,6
2873,NVL2180,0,356,356,0,0,1,1,0,356,356
2874,NWH2076,0,356,189,167,0,1,1,1,189,189
2875,NWH2896,7,416,4,419,5,12,4,12,3,3
2876,NWO3501,0,99,0,99,0,1,0,1,0,0
2877,NWV0966,10,346,356,0,1,1,1,0,346,346
2878,NYC2048,0,356,0,356,0,1,0,1,0,0
2879,NYS2040,0,356,356,0,0,1,1,0,356,356
2880,OAG1468,0,179,179,0,0,1,1,0,179,179
2881,OAP2825,332,378,256,180,57,20,57,20,76,198
2882,OAS0991,279,355,0,356,1,1,0,1,279,1
2883,OAW3013,0,356,0,356,0,1,0,1,0,0
2884,OBH3008,0,356,0,356,0,1,0,1,0,0
2885,OCC0107,1,355,356,0,1,1,1,0,355,355
2886,OCD3513,282,349,196,153,1,1,1,1,86,196
2887,OCH2853,286,499,192,247,1,1,1,1,94,252
2888,OCS1541,284,356,1,355,1,1,1,1,283,1
2889,ODB0151,0,356,181,175,0,1,1,1,181,181
2890,ODB1853,0,356,356,0,0,1,1,0,356,356
2891,ODC0002,0,356,0,356,0,1,0,1,0,0
2892,ODS0893,0,356,0,356,0,1,0,1,0,0
2893,ODW2194,0,271,271,0,0,1,1,0,271,271
2894,OED3393,463,171,0,356,1,1,0,1,463,185
2895,OEJ1648,285,421,16,417,18,7,16,8,269,4
2896,OEN0432,270,356,0,356,1,1,0,1,270,0
2897,OGD0015,486,165,208,173,25,1,24,2,278,8
2898,OGW0251,0,356,0,356,0,1,0,1,0,0
2899,OGW3384,219,156,14,361,16,4,13,6,205,205
2900,OHC1892,293,360,372,2,15,5,17,2,79,358
2901,OHD2274,72,382,70,384,69,27,68,28,2,2
2902,OHF0078,0,356,356,0,0,1,1,0,356,356
2903,OHG3736,0,356,0,356,0,1,0,1,0,0
2904,OHM1030,266,356,0,356,1,1,0,1,266,0
2905,OIP0988,0,356,0,356,0,1,0,1,0,0
2906,OJB1095,0,356,356,0,0,1,1,0,356,356
2907,OJB1538,0,356,2,354,0,1,1,1,2,2
2908,OJG3395,67,78,0,145,1,1,0,1,67,67
2909,OJM1324,0,356,356,0,0,1,1,0,356,356
2910,OJR2085,269,356,190,166,1,1,1,1,79,190
2911,OJT3599,86,119,106,13,1,1,1,1,20,106
2912,OJV2346,365,387,87,390,85,31,81,34,278,3
2913,OKF2007,0,356,0,356,0,1,0,1,0,0
2914,OKG1889,361,397,441,34,73,20,80,13,80,363
2915,OKH3777,286,539,0,458,1,1,0,1,286,81
2916,OLA2686,0,356,0,356,0,1,0,1,0,0
2917,OLB2930,293,358,218,162,23,3,24,2,75,196
2918,OLH3452,0,356,0,356,0,1,0,1,0,0
2919,OLR2564,0,356,0,356,0,1,0,1,0,0
2920,OMB2053,0,356,0,356,0,1,0,1,0,0
2921,OMB3507,0,356,192,164,0,1,1,1,192,192
2922,OMM0835,0,312,0,312,0,1,0,1,0,0
2923,OMP1671,0,356,0,356,0,1,0,1,0,0
2924,ONR3291,348,569,74,514,67,52,65,53,274,55
2925,OQL3890,287,356,0,356,1,1,0,1,287,0
2926,ORB0755,35,46,45,1,1,2,1,1,10,45
2927,ORB2880,323,327,13,359,14,4,13,4,310,32
2928,ORH2010,306,489,9,467,11,20,9,22,297,22
2929,ORJ1401,0,356,0,356,0,1,0,1,0,0
2930,ORM1484,339,404,418,42,54,16,57,11,79,362
2931,OSC1925,57,375,422,10,54,20,60,10,365,365
2932,OTD1228,45,388,47,386,43,33,45,31,2,2
2933,OUH0741,0,356,356,0,0,1,1,0,356,356
2934,OUJ2510,0,356,356,0,0,1,1,0,356,356
2935,OVM1496,0,356,356,0,0,1,1,0,356,356
2936,OWC2563,0,147,0,147,0,1,0,1,0,0
2937,OWD0981,0,356,356,0,0,1,1,0,356,356
2938,OWL2872,17,360,208,169,17,5,17,6,191,191
2939,OXS0363,0,356,356,0,0,1,1,0,356,356
2940,OZH2737,0,356,0,356,0,1,0,1,0,0
2941,PAA2738,353,392,79,390,70,37,71,35,274,2
2942,PAB0879,1,355,1,355,1,1,1,1,0,0
2943,PAF1373,332,371,65,371,63,16,61,16,267,0
2944,PAM0505,0,356,0,356,0,1,0,1,0,0
2945,PAS2864,0,356,193,163,0,1,1,1,193,193
2946,PCA3212,0,85,85,0,0,1,1,0,85,85
2947,PCA3344,20,359,20,359,20,4,20,4,0,0
2948,PCB0545,6,350,356,0,1,1,1,0,350,350
2949,PCB1603,0,356,356,0,0,1,1,0,356,356
2950,PCC0604,0,356,199,157,0,1,1,1,199,199
2951,PCM0609,9,435,196,248,9,7,12,5,187,187
2952,PCS1747,0,356,187,169,0,1,1,1,187,187
2953,PCT1234,178,229,0,229,1,1,0,1,178,0
2954,PDC1453,186,170,0,356,1,1,0,1,186,186
2955,PDG2607,267,421,0,421,1,1,0,1,267,0
2956,PDJ3711,0,356,0,356,0,1,0,1,0,0
2957,PDK3856,0,356,0,356,0,1,0,1,0,0
2958,PDM0304,3,353,356,0,1,1,1,0,353,353
2959,PEB3161,0,356,197,159,0,1,1,1,197,197
2960,PEB3768,0,356,0,356,0,1,0,1,0,0
2961,PEC0475,35,0,0,35,1,0,0,1,35,35
2962,PEV3531,0,356,356,0,0,1,1,0,356,356
2963,PEV3955,283,550,194,299,1,1,1,1,89,251
2964,PFC3807,0,356,0,356,0,1,0,1,0,0
2965,PGF3491,0,415,0,415,0,1,0,1,0,0
2966,PGM0342,279,356,0,356,1,1,0,1,279,0
2967,PGS3797,0,356,0,356,0,1,0,1,0,0
2968,PHA0726,0,356,0,356,0,1,0,1,0,0
2969,PHB0124,350,379,68,378,61,24,59,23,282,1
2970,PHB2209,0,356,0,356,0,1,0,1,0,0
2971,PHH1524,16,429,372,73,16,5,17,5,356,356
2972,PHO1937,368,369,444,9,77,14,81,9,76,360
2973,PIG2047,0,356,0,356,0,1,0,1,0,0
2974,PIM3569,271,356,356,0,1,1,1,0,85,356
2975,PIP3915,279,357,356,0,1,1,1,0,77,357
2976,PJC1252,20,483,40,463,20,8,21,8,20,20
2977,PJF2579,0,356,0,356,0,1,0,1,0,0
2978,PJM3025,0,79,79,0,0,1,1,0,79,79
2979,PJP2632,278,356,176,180,1,1,1,1,102,176
2980,PJS2078,0,356,204,152,0,1,1,1,204,204
2981,PKB2483,642,0,0,356,1,0,0,1,642,356
2982,PKB2732,0,356,0,356,0,1,0,1,0,0
2983,PKH0730,0,239,0,239,0,1,0,1,0,0
2984,PKR1145,19,431,385,65,18,7,20,6,366,366
2985,PLH0411,0,356,356,0,0,1,1,0,356,356
2986,PLH1807,26,395,383,38,24,13,28,9,357,357
2987,PLJ1771,159,580,200,425,46,388,44,390,41,155
2988,PLJ3274,0,356,0,356,0,1,0,1,0,0
2989,PLM3935,0,356,199,157,0,1,1,1,199,199
2990,PLT3283,0,356,0,356,0,1,0,1,0,0
2991,PMA2693,0,356,0,356,0,1,0,1,0,0
2992,PMF0768,383,372,466,11,95,16,100,11,83,361
2993,PMG0284,0,356,356,0,0,1,1,0,356,356
2994,PMG1376,0,356,356,0,0,1,1,0,356,356
2995,PMG2513,0,356,356,0,0,1,1,0,356,356
2996,PMH3484,365,382,96,378,82,27,84,23,269,4
2997,PMM0696,320,377,403,17,44,22,47,17,83,360
2998,PMT2264,0,356,0,356,0,1,0,1,0,0
2999,PNH1444,196,231,0,427,1,1,0,1,196,196
3000,PNL0018,277,356,0,356,1,1,0,1,277,0
3001,POD0750,367,373,447,9,73,18,81,9,80,364
3002,POS0615,0,412,356,56,0,1,1,1,356,356
3003,PPG2889,395,386,110,388,99,31,97,32,285,2
3004,PPP1295,335,522,250,274,44,16,43,16,85,248
3005,PPT3162,0,356,204,152,0,1,1,1,204,204
3006,PRH1717,0,356,356,0,0,1,1,0,356,356
3007,PRH2431,103,1337,290,1150,99,854,100,853,187,187
3008,PSC1608,0,356,356,0,0,1,1,0,356,356
3009,PSD1409,283,395,6,395,6,2,6,1,277,0
3010,PSG1938,0,233,233,0,0,1,1,0,233,233
3011,PSH3834,0,356,0,356,0,1,0,1,0,0
3012,PSP3592,301,359,380,1,22,4,24,1,79,358
3013,PSS2051,281,356,0,356,1,1,0,1,281,0
3014,PTG0587,0,356,0,356,0,1,0,1,0,0
3015,PTO1063,81,1325,77,1329,80,868,76,869,4,4
3016,PTR2613,0,356,0,356,0,1,0,1,0,0
3017,PTS0531,9,359,367,1,9,4,12,1,358,358
3018,PTS2487,619,51,0,399,1,1,0,1,619,348
3019,PVV3999,58,78,1,77,1,1,1,1,57,1
3020,PWG3063,0,356,356,0,0,1,1,0,356,356
3021,PWM0708,282,357,356,0,1,1,1,0,74,357
3022,PXR3453,0,356,0,356,0,1,0,1,0,0
3023,QAH0048,389,1340,111,1348,118,879,109,886,278,8
3024,QAH1315,291,579,206,325,9,9,10,8,85,254
3025,QAS1692,278,356,0,356,1,1,0,1,278,0
3026,QBH3579,280,355,0,356,1,1,0,1,280,1
3027,QBL1386,289,529,364,90,1,1,1,1,75,439
3028,QBR2250,278,356,356,0,1,1,1,0,78,356
3029,QCB1360,0,356,0,356,0,1,0,1,0,0
3030,QCD0386,0,356,0,356,0,1,0,1,0,0
3031,QCN2206,197,269,10,269,12,3,10,4,187,0
3032,QFD1857,0,356,356,0,0,1,1,0,356,356
3033,QFP3467,299,357,16,356,16,2,16,1,283,1
3034,QGH0041,362,1353,85,1355,86,845,84,846,277,2
3035,QGS1841,326,311,0,356,1,1,0,1,326,45
3036,QGS3009,0,356,356,0,0,1,1,0,356,356
3037,QHF3151,0,356,191,165,0,1,1,1,191,191
3038,QIC1832,0,356,0,356,0,1,0,1,0,0
3039,QIS2940,183,173,0,356,1,1,0,1,183,183
3040,QIT3029,0,356,356,0,0,1,1,0,356,356
3041,QJA3887,0,356,0,356,0,1,0,1,0,0
3042,QJF3038,102,1335,99,1338,99,861,96,864,3,3
3043,QJO1715,689,6,48,366,51,6,46,11,641,360
3044,QKO2718,0,356,356,0,0,1,1,0,356,356
3045,QKP3927,0,356,356,0,0,1,1,0,356,356
3046,QKV2583,0,356,0,356,0,1,0,1,0,0
3047,QLC0082,0,356,0,356,0,1,0,1,0,0
3048,QLW2245,1,368,357,12,1,3,2,3,356,356
3049,QMP2998,0,356,0,356,0,1,0,1,0,0
3050,QMV2796,0,356,0,356,0,1,0,1,0,0
3051,QNC3717,0,356,0,356,0,1,0,1,0,0
3052,QNG2121,0,356,356,0,0,1,1,0,356,356
3053,QNW0977,0,356,356,0,0,1,1,0,356,356
3054,QRJ0691,0,356,356,0,0,1,1,0,356,356
3055,QRJ1597,301,417,383,43,25,25,25,25,82,374
3056,QRR1242,0,356,0,356,0,1,0,1,0,0
3057,QSB1577,352,388,76,389,70,33,69,34,276,1
3058,QSG2525,279,356,356,0,1,1,1,0,77,356
3059,QSG3297,0,356,0,356,0,1,0,1,0,0
3060,QSM3147,0,356,185,171,0,1,1,1,185,185
3061,QWL3474,341,406,425,48,60,19,62,17,84,358
3062,QXH0396,208,267,267,0,1,1,1,0,59,267
3063,QYG1180,375,390,92,390,81,33,79,34,283,0
3064,RAA0675,0,356,198,158,0,1,1,1,198,198
3065,RAA1455,203,286,0,489,1,1,0,1,203,203
3066,RAA3570,358,386,439,22,64,28,69,21,81,364
3067,RAB0455,0,356,0,356,0,1,0,1,0,0
3068,RAB1712,0,356,356,0,0,1,1,0,356,356
3069,RAB2739,0,356,0,356,0,1,0,1,0,0
3070,RAC0362,0,356,356,0,0,1,1,0,356,356
3071,RAF1290,0,356,187,169,0,1,1,1,187,187
3072,RAF3369,0,294,0,294,0,1,0,1,0,0
3073,RAH1514,2,358,358,2,2,3,3,2,356,356
3074,RAH2750,0,356,0,356,0,1,0,1,0,0
3075,RAH3181,0,191,0,191,0,1,0,1,0,0
3076,RAI1483,0,356,356,0,0,1,1,0,356,356
3077,RAP0653,0,313,179,134,0,1,1,1,179,179
3078,RAS0223,0,356,0,356,0,1,0,1,0,0
3079,RAS0356,0,356,356,0,0,1,1,0,356,356
3080,RAS3446,40,315,41,315,1,1,1,1,1,0
3081,RAW3461,0,356,0,356,0,1,0,1,0,0
3082,RBB0585,0,356,0,356,0,1,0,1,0,0
3083,RBB3867,0,356,356,0,0,1,1,0,356,356
3084,RBG3850,0,356,0,356,0,1,0,1,0,0
3085,RBH3142,0,356,183,173,0,1,1,1,183,183
3086,RBO0327,0,356,0,356,0,1,0,1,0,0
3087,RBP1171,175,197,21,198,23,11,21,12,154,1
3088,RCB0302,189,167,0,356,1,1,0,1,189,189
3089,RCB2424,95,1332,277,1150,93,868,90,871,182,182
3090,RCB2645,0,356,193,163,0,1,1,1,193,193
3091,RCD2501,30,326,0,356,1,1,0,1,30,30
3092,RCF0044,422,1524,127,1514,134,955,125,963,295,10
3093,RCF0054,287,383,18,382,20,26,18,27,269,1
3094,RCF2057,0,356,0,356,0,1,0,1,0,0
3095,RCG0105,120,287,380,27,25,6,25,6,260,260
3096,RCG1241,0,356,0,356,0,1,0,1,0,0
3097,RCH2447,286,669,363,201,1,1,1,1,77,468
3098,RCH3533,274,360,356,0,1,1,1,0,82,360
3099,RCH3740,0,356,0,356,0,1,0,1,0,0
3100,RCJ0557,0,356,356,0,0,1,1,0,356,356
3101,RCL0068,0,356,0,356,0,1,0,1,0,0
3102,RCM1372,281,356,0,356,1,1,0,1,281,0
3103,RCM3458,0,356,0,356,0,1,0,1,0,0
3104,RCS2064,359,532,64,487,64,51,61,55,295,45
3105,RCT1697,344,611,52,521,51,36,47,40,292,90
3106,RCV1311,0,355,193,163,0,1,1,1,193,192
3107,RCW2838,0,356,178,178,0,1,1,1,178,178
3108,RCW3692,30,326,356,0,1,1,1,0,326,326
3109,RDA3381,507,187,17,380,20,4,16,7,490,193
3110,RDB0702,0,356,356,0,0,1,1,0,356,356
3111,RDB1645,0,356,0,356,0,1,0,1,0,0
3112,RDB1693,0,356,0,356,0,1,0,1,0,0
3113,RDC0378,0,356,190,166,0,1,1,1,190,190
3114,RDE3239,0,356,0,356,0,1,0,1,0,0
3115,RDF1248,286,356,0,356,1,1,0,1,286,0
3116,RDM1174,0,356,0,356,0,1,0,1,0,0
3117,RDP2116,0,356,356,0,0,1,1,0,356,356
3118,RDW0957,0,356,356,0,0,1,1,0,356,356
3119,REB0123,358,372,77,374,68,17,66,18,281,2
3120,REC0283,357,676,69,579,66,87,64,89,288,97
3121,REC2555,0,356,0,356,0,1,0,1,0,0
3122,REF3266,291,404,372,47,16,2,17,1,81,357
3123,REG2171,285,356,356,0,1,1,1,0,71,356
3124,REJ2666,317,373,402,2,31,6,35,2,85,371
3125,REK1037,378,381,96,382,87,25,84,27,282,1
3126,REL3735,0,356,0,356,0,1,0,1,0,0
3127,REM0580,285,522,58,453,54,38,53,39,227,69
3128,RFB2959,469,162,0,356,1,1,0,1,469,194
3129,RFJ2193,0,356,356,0,0,1,1,0,356,356
3130,RFS1633,288,356,356,0,1,1,1,0,68,356
3131,RFS2923,0,356,192,164,0,1,1,1,192,192
3132,RGB0263,0,356,0,356,0,1,0,1,0,0
3133,RGB0901,0,356,0,356,0,1,0,1,0,0
3134,RGB1346,267,356,356,0,1,1,1,0,89,356
3135,RGB1581,343,393,67,394,64,38,63,39,276,1
3136,RGB1869,0,356,356,0,0,1,1,0,356,356
3137,RGM3111,0,356,356,0,0,1,1,0,356,356
3138,RGP0451,279,356,0,356,1,1,0,1,279,0
3139,RGR0706,0,356,356,0,0,1,1,0,356,356
3140,RHA3613,0,356,356,0,0,1,1,0,356,356
3141,RHB1721,0,356,0,356,0,1,0,1,0,0
3142,RHD0787,0,356,0,356,0,1,0,1,0,0
3143,RHF0046,81,1341,76,1346,79,862,74,867,5,5
3144,RHG1647,0,356,0,356,0,1,0,1,0,0
3145,RHL0268,518,176,35,366,38,8,34,11,483,190
3146,RHM3909,0,356,356,0,0,1,1,0,356,356
3147,RHO0678,0,523,189,334,0,1,1,1,189,189
3148,RHR2835,54,389,255,188,51,13,54,11,201,201
3149,RIB1582,272,356,0,356,1,1,0,1,272,0
3150,RIE2876,278,356,0,356,1,1,0,1,278,0
3151,RIJ2470,356,0,0,356,1,0,0,1,356,356
3152,RIK1631,0,356,356,0,0,1,1,0,356,356
3153,RIS2436,100,1348,291,1157,96,876,94,879,191,191
3154,RJA0402,41,415,40,416,41,10,40,11,1,1
3155,RJB1151,0,356,356,0,0,1,1,0,356,356
3156,RJB1424,0,356,0,356,0,1,0,1,0,0
3157,RJB2622,356,0,0,356,1,0,0,1,356,356
3158,RJD2647,0,356,189,167,0,1,1,1,189,189
3159,RJF3299,91,387,96,382,83,31,86,27,5,5
3160,RJF3634,0,270,0,270,0,1,0,1,0,0
3161,RJG2239,334,373,432,9,67,17,73,9,98,364
3162,RJG3325,308,366,37,364,35,11,36,9,271,2
3163,RJH0219,338,530,57,486,54,32,54,31,281,44
3164,RJH3796,0,356,0,356,0,1,0,1,0,0
3165,RJM0343,0,356,0,356,0,1,0,1,0,0
3166,RJM3227,0,356,0,356,0,1,0,1,0,0
3167,RJM3957,355,375,277,175,71,20,74,17,78,200
3168,RJO1791,0,356,0,356,0,1,0,1,0,0
3169,RJP1091,0,356,0,356,0,1,0,1,0,0
3170,RJS0846,201,155,0,356,1,1,0,1,201,201
3171,RJS3256,0,137,137,0,0,1,1,0,137,137
3172,RJS3479,0,356,356,0,0,1,1,0,356,356
3173,RJW1440,269,356,0,356,1,1,0,1,269,0
3174,RJW2318,0,356,13,343,0,1,1,1,13,13
3175,RKA2561,0,356,0,356,0,1,0,1,0,0
3176,RKE1589,0,356,356,0,0,1,1,0,356,356
3177,RKG2587,87,269,0,356,1,1,0,1,87,87
3178,RKH1569,274,356,0,356,1,1,0,1,274,0
3179,RKH1801,0,356,356,0,0,1,1,0,356,356
3180,RKH2877,302,371,15,369,16,3,15,3,287,2
3181,RKH3803,0,356,0,356,0,1,0,1,0,0
3182,RKJ3379,0,299,0,299,0,1,0,1,0,0
3183,RKL2682,0,356,0,356,0,1,0,1,0,0
3184,RKM3650,0,356,0,356,0,1,0,1,0,0
3185,RKW1754,0,356,189,167,0,1,1,1,189,189
3186,RLB1334,390,378,471,13,98,23,105,13,81,365
3187,RLH0358,201,256,0,256,1,1,0,1,201,0
3188,RLH1548,0,356,7,349,0,1,1,1,7,7
3189,RLK3490,374,374,92,374,81,20,81,18,282,0
3190,RLP3268,357,444,443,53,73,16,75,13,86,391
3191,RLR0365,0,356,0,356,0,1,0,1,0,0
3192,RLS0761,197,159,0,356,1,1,0,1,197,197
3193,RLS1738,81,368,76,373,74,13,68,17,5,5
3194,RMB0885,0,356,0,356,0,1,0,1,0,0
3195,RMB2275,0,356,0,356,0,1,0,1,0,0
3196,RMC2177,0,356,356,0,0,1,1,0,356,356
3197,RMD0792,7,428,8,427,7,31,8,30,1,1
3198,RME0448,367,388,88,390,81,31,78,34,279,2
3199,RME2477,356,0,1,355,1,0,1,1,355,355
3200,RML2759,71,386,433,24,65,30,72,23,362,362
3201,RML2789,0,356,0,356,0,1,0,1,0,0
3202,RMN1355,0,356,356,0,0,1,1,0,356,356
3203,RMO2439,81,1280,268,1093,80,840,79,842,187,187
3204,RMP3510,0,257,132,125,0,1,1,1,132,132
3205,RMR0341,0,356,59,297,0,1,1,1,59,59
3206,RMR2694,0,356,356,0,0,1,1,0,356,356
3207,RNB0519,0,355,0,356,0,1,0,1,0,1
3208,RNB2679,0,45,0,45,0,1,0,1,0,0
3209,RNC3417,0,322,0,322,0,1,0,1,0,0
3210,RND1473,0,356,356,0,0,1,1,0,356,356
3211,RNM0466,147,1261,95,1313,96,840,92,843,52,52
3212,ROA3171,198,199,65,191,56,9,59,5,133,8
3213,ROB2744,0,356,0,356,0,1,0,1,0,0
3214,ROH1347,0,355,356,0,0,1,1,0,356,355
3215,ROH3778,0,356,0,356,0,1,0,1,0,0
3216,ROR3483,0,500,0,500,0,1,0,1,0,0
3217,ROR3967,0,356,0,356,0,1,0,1,0,0
3218,ROS2030,31,325,356,0,1,1,1,0,325,325
3219,RPB0029,0,588,363,225,0,1,1,1,363,363
3220,RPC0205,7,409,356,60,1,1,1,1,349,349
3221,RPF2614,356,0,0,356,1,0,0,1,356,356
3222,RPG0403,0,356,0,356,0,1,0,1,0,0
3223,RPH2326,2,368,2,368,2,13,2,13,0,0
3224,RPL2640,0,356,198,158,0,1,1,1,198,198
3225,RPS3617,8,381,366,23,8,5,11,3,358,358
3226,RPW0026,21,17,22,16,1,1,1,1,1,1
3227,RPW2445,0,356,356,0,0,1,1,0,356,356
3228,RQN2039,305,357,390,0,32,2,33,0,85,357
3229,RQR3924,0,119,119,0,0,1,1,0,119,119
3230,RRA0643,356,0,15,341,1,0,1,1,341,341
3231,RRD2697,270,356,356,0,1,1,1,0,86,356
3232,RRH0638,77,0,5,40,6,0,5,1,72,40
3233,RRH3057,309,426,381,74,23,7,23,7,72,352
3234,RRM2175,0,356,356,0,0,1,1,0,356,356
3235,RRM3789,0,356,0,356,0,1,0,1,0,0
3236,RRS2359,278,356,0,356,1,1,0,1,278,0
3237,RRT1417,274,356,0,356,1,1,0,1,274,0
3238,RSA2941,34,27,0,61,1,1,0,1,34,34
3239,RSE2181,0,356,356,0,0,1,1,0,356,356
3240,RSE2382,0,356,0,356,0,1,0,1,0,0
3241,RSG0687,350,387,448,21,76,29,83,20,98,366
3242,RSG2931,0,356,189,167,0,1,1,1,189,189
3243,RSJ0891,10,346,107,249,1,1,1,1,97,97
3244,RSM1089,0,356,0,356,0,1,0,1,0,0
3245,RSM3742,0,356,0,356,0,1,0,1,0,0
3246,RSR2681,0,356,0,356,0,1,0,1,0,0
3247,RSS0875,287,356,0,356,1,1,0,1,287,0
3248,RSS3182,12,192,25,179,12,2,13,2,13,13
3249,RSV2438,376,1337,277,1158,97,860,93,864,99,179
3250,RSV3166,155,191,5,187,2,1,2,1,150,4
3251,RSW3232,0,356,0,356,0,1,0,1,0,0
3252,RTA1201,0,79,79,0,0,1,1,0,79,79
3253,RTD0762,186,170,0,356,1,1,0,1,186,186
3254,RTM0849,198,158,0,356,1,1,0,1,198,198
3255,RTN3680,294,368,15,367,15,12,15,11,279,1
3256,RTP0754,326,448,406,55,44,17,48,13,80,393
3257,RTS2009,31,470,32,469,30,13,31,12,1,1
3258,RTW2758,0,356,356,0,0,1,1,0,356,356
3259,RUB1156,316,372,44,374,45,17,42,19,272,2
3260,RUC1198,0,356,356,0,0,1,1,0,356,356
3261,RVB0303,513,198,41,392,42,31,38,35,472,194
3262,RVH0535,352,364,437,4,73,9,77,4,85,360
3263,RVL1688,0,356,0,356,0,1,0,1,0,0
3264,RVR0095,0,356,356,0,0,1,1,0,356,356
3265,RVV0317,305,536,13,465,15,14,13,15,292,71
3266,RWH3312,301,363,25,363,26,7,25,7,276,0
3267,RWN1705,59,380,261,178,56,11,60,8,202,202
3268,RWS3699,361,549,438,126,72,26,76,22,77,423
3269,RXG1504,0,356,356,0,0,1,1,0,356,356
3270,RXN2265,383,377,97,378,87,22,85,23,286,1
3271,SAB0817,18,357,18,357,18,2,18,2,0,0
3272,SAB1954,295,536,11,486,12,10,11,10,284,50
3273,SAB2761,0,356,356,0,0,1,1,0,356,356
3274,SAB3286,363,383,95,378,80,25,81,21,268,5
3275,SAB3860,351,458,61,424,59,19,57,20,290,34
3276,SAC0374,0,147,0,147,0,1,0,1,0,0
3277,SAC3963,0,356,0,356,0,1,0,1,0,0
3278,SAD3259,368,479,447,71,73,25,77,18,79,408
3279,SAH2292,0,356,356,0,0,1,1,0,356,356
3280,SAL2493,0,356,0,356,0,1,0,1,0,0
3281,SAM2567,0,356,0,356,0,1,0,1,0,0
3282,SAM3782,0,356,0,356,0,1,0,1,0,0
3283,SAM3855,333,509,51,450,50,18,49,19,282,59
3284,SAM3862,0,356,0,356,0,1,0,1,0,0
3285,SAP1888,0,356,356,0,0,1,1,0,356,356
3286,SAP2173,0,356,356,0,0,1,1,0,356,356
3287,SAP3390,541,192,72,382,64,24,62,25,469,190
3288,SAR1883,0,356,356,0,0,1,1,0,356,356
3289,SAR2066,296,579,0,480,1,1,0,1,296,99
3290,SAS1098,0,356,356,0,0,1,1,0,356,356
3291,SAT3766,311,385,27,385,26,29,25,29,284,0
3292,SAV3457,26,330,33,323,1,1,1,1,7,7
3293,SBD1557,0,356,0,356,0,1,0,1,0,0
3294,SBG3983,19,422,17,424,19,21,16,25,2,2
3295,SBH3683,0,356,356,0,0,1,1,0,356,356
3296,SBJ3628,0,356,356,0,0,1,1,0,356,356
3297,SBK3515,0,356,182,174,0,1,1,1,182,182
3298,SBM2719,0,356,356,0,0,1,1,0,356,356
3299,SBO3115,0,356,356,0,0,1,1,0,356,356
3300,SBS1606,0,356,356,0,0,1,1,0,356,356
3301,SBT2281,0,356,0,356,0,1,0,1,0,0
3302,SBT2585,0,355,0,356,0,1,0,1,0,1
3303,SBW3023,0,356,356,0,0,1,1,0,356,356
3304,SCB1280,277,356,187,169,1,1,1,1,90,187
3305,SCB2814,288,356,0,356,1,1,0,1,288,0
3306,SCC0067,638,0,0,356,1,0,0,1,638,356
3307,SCC1896,0,355,356,0,0,1,1,0,356,355
3308,SCC2526,0,356,356,0,0,1,1,0,356,356
3309,SCD2333,0,356,47,309,0,1,1,1,47,47
3310,SCD3192,0,355,356,0,0,1,1,0,356,355
3311,SCE1877,280,361,378,2,20,6,23,2,98,359
3312,SCF0330,0,356,0,356,0,1,0,1,0,0
3313,SCG2695,5,351,356,0,1,1,1,0,351,351
3314,SCH1013,0,356,0,356,0,1,0,1,0,0
3315,SCH3567,0,355,356,0,0,1,1,0,356,355
3316,SCH3716,0,356,0,356,0,1,0,1,0,0
3317,SCH3858,0,356,0,356,0,1,0,1,0,0
3318,SCJ0179,302,446,222,249,25,22,27,20,80,197
3319,SCJ2279,0,356,0,356,0,1,0,1,0,0
3320,SCL0022,0,356,356,0,0,1,1,0,356,356
3321,SCL2577,5,399,5,399,5,22,5,22,0,0
3322,SCM0778,0,356,356,0,0,1,1,0,356,356
3323,SCM2538,0,356,0,356,0,1,0,1,0,0
3324,SCM3407,531,233,59,426,58,12,54,17,472,193
3325,SCM3950,278,356,180,176,1,1,1,1,98,180
3326,SCP1116,0,356,0,356,0,1,0,1,0,0
3327,SCP3664,0,356,0,356,0,1,0,1,0,0
3328,SCR0898,0,356,0,356,0,1,0,1,0,0
3329,SCR2455,286,361,374,3,17,6,18,3,88,358
3330,SDB3500,0,356,0,356,0,1,0,1,0,0
3331,SDC2793,271,356,0,356,1,1,0,1,271,0
3332,SDC3561,177,223,233,4,15,6,16,4,56,219
3333,SDE2662,288,365,197,174,7,10,6,11,91,191
3334,SDF3082,1,355,0,356,1,1,0,1,1,1
3335,SDH1556,0,420,0,420,0,1,0,1,0,0
3336,SDH2394,66,530,65,531,62,39,61,39,1,1
3337,SDM2550,276,356,0,356,1,1,0,1,276,0
3338,SDM3560,0,356,356,0,0,1,1,0,356,356
3339,SDN2932,367,373,297,174,83,18,89,12,70,199
3340,SDR1227,0,356,0,356,0,1,0,1,0,0
3341,SDW0370,360,385,92,382,81,29,80,26,268,3
3342,SED0972,0,356,356,0,0,1,1,0,356,356
3343,SEM1862,276,356,356,0,1,1,1,0,80,356
3344,SEM1983,217,0,0,123,1,0,0,1,217,123
3345,SEM2492,0,356,0,356,0,1,0,1,0,0
3346,SEN0534,0,356,356,0,0,1,1,0,356,356
3347,SER0621,0,567,362,205,0,1,1,1,362,362
3348,SER2158,0,356,356,0,0,1,1,0,356,356
3349,SES2670,58,370,419,9,56,14,62,8,361,361
3350,SFC2336,0,301,0,301,0,1,0,1,0,0
3351,SFE0723,0,356,0,356,0,1,0,1,0,0
3352,SFL0092,0,356,356,0,0,1,1,0,356,356
3353,SFM2226,0,356,356,0,0,1,1,0,356,356
3354,SGB1636,0,356,356,0,0,1,1,0,356,356
3355,SGC1001,0,356,0,356,0,1,0,1,0,0
3356,SGC2111,353,412,74,411,68,52,67,51,279,1
3357,SGF2611,109,382,111,380,97,27,101,24,2,2
3358,SGK1941,368,386,458,18,84,31,94,18,90,368
3359,SGM2153,0,301,301,0,0,1,1,0,301,301
3360,SGP1124,285,356,356,0,1,1,1,0,71,356
3361,SGP2174,0,355,356,0,0,1,1,0,356,355
3362,SGR0658,0,356,183,173,0,1,1,1,183,183
3363,SGR1164,23,372,24,371,23,16,24,16,1,1
3364,SGV2780,0,356,0,356,0,1,0,1,0,0
3365,SGW0112,295,356,12,359,12,5,12,4,283,3
3366,SGW0443,0,356,0,356,0,1,0,1,0,0
3367,SHB2106,0,356,0,356,0,1,0,1,0,0
3368,SHB3512,10,444,211,243,9,6,11,5,201,201
3369,SHC1585,0,356,356,0,0,1,1,0,356,356
3370,SHG1281,0,356,176,180,0,1,1,1,176,176
3371,SHH0970,269,356,356,0,1,1,1,0,87,356
3372,SHM2429,103,1353,273,1183,103,873,98,877,170,170
3373,SHN0104,0,55,55,0,0,1,1,0,55,55
3374,SHP1418,364,420,102,404,82,28,80,31,262,16
3375,SHP1713,0,356,356,0,0,1,1,0,356,356
3376,SHS3176,8,348,64,292,1,1,1,1,56,56
3377,SHT3548,0,356,0,356,0,1,0,1,0,0
3378,SHW3011,0,356,0,356,0,1,0,1,0,0
3379,SIM3373,0,356,0,356,0,1,0,1,0,0
3380,SIP2293,19,360,375,4,19,5,20,4,356,356
3381,SIP2907,274,356,187,169,1,1,1,1,87,187
3382,SIR3201,328,389,410,25,47,30,49,25,82,364
3383,SIS3576,2,410,2,410,2,13,2,13,0,0
3384,SIW2528,374,382,465,17,88,27,94,17,91,365
3385,SJB0086,0,356,0,356,0,1,0,1,0,0
3386,SJB2984,0,356,356,0,0,1,1,0,356,356
3387,SJC3900,362,380,99,377,84,25,89,22,263,3
3388,SJD3032,0,355,356,0,0,1,1,0,356,355
3389,SJF3798,0,407,0,407,0,1,0,1,0,0
3390,SJG1194,0,356,356,0,0,1,1,0,356,356
3391,SJG1510,0,356,356,0,0,1,1,0,356,356
3392,SJH0945,0,356,356,0,0,1,1,0,356,356
3393,SJL3355,273,356,0,356,1,1,0,1,273,0
3394,SJM3805,0,356,0,356,0,1,0,1,0,0
3395,SJN1601,21,359,378,2,21,4,23,2,357,357
3396,SJR0452,0,356,0,356,0,1,0,1,0,0
3397,SJS0323,90,77,0,167,1,1,0,1,90,90
3398,SJS1014,0,356,0,356,0,1,0,1,0,0
3399,SJS1415,0,356,7,349,0,1,1,1,7,7
3400,SJT0698,345,382,429,22,66,25,69,21,84,360
3401,SJW0184,0,356,198,158,0,1,1,1,198,198
3402,SJW3131,275,366,372,6,14,9,16,6,97,360
3403,SJY3732,0,356,0,356,0,1,0,1,0,0
3404,SKA0757,189,167,0,356,1,1,0,1,189,189
3405,SKB2635,0,356,185,171,0,1,1,1,185,185
3406,SKB3336,0,382,0,382,0,1,0,1,0,0
3407,SKB3752,0,356,0,356,0,1,0,1,0,0
3408,SKE3262,14,472,380,106,13,3,14,3,366,366
3409,SKF2105,213,304,5,304,6,3,5,3,208,0
3410,SKG1731,0,356,356,0,0,1,1,0,356,356
3411,SKK0282,0,356,0,356,0,1,0,1,0,0
3412,SKL0739,0,356,356,0,0,1,1,0,356,356
3413,SKM1287,0,356,201,155,0,1,1,1,201,201
3414,SKM1369,0,356,0,356,0,1,0,1,0,0
3415,SKM3058,0,356,356,0,0,1,1,0,356,356
3416,SKP3263,0,356,356,0,0,1,1,0,356,356
3417,SKS0339,25,472,25,472,24,13,24,13,0,0
3418,SLB2519,0,356,356,0,0,1,1,0,356,356
3419,SLB3039,83,1330,77,1336,81,868,75,874,6,6
3420,SLC0017,0,356,356,0,0,1,1,0,356,356
3421,SLC1588,0,412,357,55,0,1,1,1,357,357
3422,SLD1639,0,356,356,0,0,1,1,0,356,356
3423,SLH0900,0,356,0,356,0,1,0,1,0,0
3424,SLL0504,0,356,0,356,0,1,0,1,0,0
3425,SLM1119,363,390,91,394,85,33,82,37,272,4
3426,SLM2404,0,356,356,0,0,1,1,0,356,356
3427,SLS0834,265,356,0,356,1,1,0,1,265,0
3428,SLS2992,0,356,356,0,0,1,1,0,356,356
3429,SLV2969,300,368,384,10,27,13,28,10,84,358
3430,SMC2898,369,270,2,354,1,1,1,1,367,84
3431,SME0418,0,356,356,0,0,1,1,0,356,356
3432,SME1984,356,0,2,354,1,0,1,1,354,354
3433,SMG1268,209,271,151,120,1,1,1,1,58,151
3434,SMG1794,0,356,356,0,0,1,1,0,356,356
3435,SMH1953,0,356,0,356,0,1,0,1,0,0
3436,SMH2222,0,356,0,356,0,1,0,1,0,0
3437,SML1923,346,378,429,17,64,23,68,17,83,361
3438,SMM3221,0,356,0,356,0,1,0,1,0,0
3439,SMN1103,294,360,380,2,22,5,24,2,86,358
3440,SMO0458,85,1319,80,1324,84,857,79,861,5,5
3441,SMR0338,281,356,0,356,1,1,0,1,281,0
3442,SMS1114,0,356,0,356,0,1,0,1,0,0
3443,SMS2452,352,380,442,19,72,26,76,19,90,361
3444,SMW2062,0,356,0,356,0,1,0,1,0,0
3445,SNC1837,271,356,0,356,1,1,0,1,271,0
3446,SNM1257,0,356,0,356,0,1,0,1,0,0
3447,SNM1696,0,356,0,356,0,1,0,1,0,0
3448,SNV2423,271,357,356,0,1,1,1,0,85,357
3449,SNW0798,0,356,0,356,0,1,0,1,0,0
3450,SOB0089,0,437,0,437,0,1,0,1,0,0
3451,SOD0442,347,384,74,379,65,29,69,24,273,5
3452,SOH3595,0,356,356,0,0,1,1,0,356,356
3453,SOK1299,0,55,34,21,0,1,1,1,34,34
3454,SOM2865,331,361,235,167,39,6,41,4,96,194
3455,SPM1684,0,356,0,356,0,1,0,1,0,0
3456,SPP2313,0,356,17,339,0,1,1,1,17,17
3457,SPW0753,0,356,356,0,0,1,1,0,356,356
3458,SQC2334,288,357,78,278,1,1,1,1,210,79
3459,SRA3210,339,410,443,35,79,38,82,33,104,375
3460,SRB2276,381,541,102,475,79,54,84,45,279,66
3461,SRB2600,289,361,15,361,15,6,14,6,274,0
3462,SRC2524,0,356,356,0,0,1,1,0,356,356
3463,SRH3590,0,356,0,356,0,1,0,1,0,0
3464,SRL3525,0,356,356,0,0,1,1,0,356,356
3465,SRM1112,279,356,0,356,1,1,0,1,279,0
3466,SRM3245,281,356,0,356,1,1,0,1,281,0
3467,SRN2617,723,16,93,384,92,16,82,28,630,368
3468,SRP2080,0,355,185,171,0,1,1,1,185,184
3469,SRR2711,369,566,443,129,63,52,73,42,74,437
3470,SRS0129,650,279,9,525,11,18,9,19,641,246
3471,SSA0346,0,356,39,317,0,1,1,1,39,39
3472,SSA0389,0,356,356,0,0,1,1,0,356,356
3473,SSA1793,90,383,456,17,82,26,90,17,366,366
3474,SSD3197,0,356,356,0,0,1,1,0,356,356
3475,SSF3031,0,356,356,0,0,1,1,0,356,356
3476,SSH1649,0,355,0,356,0,1,0,1,0,1
3477,SSH1845,36,320,0,356,1,1,0,1,36,36
3478,SSL2271,370,377,93,384,92,20,84,27,277,7
3479,SSM3894,272,356,0,356,1,1,0,1,272,0
3480,SSO2406,62,294,0,356,1,1,0,1,62,62
3481,SSR1962,74,380,77,377,68,25,72,22,3,3
3482,SSS3091,357,465,278,237,72,35,75,32,79,228
3483,SST1661,364,393,93,390,87,33,85,34,271,3
3484,STC2042,0,356,356,0,0,1,1,0,356,356
3485,STC3053,96,1337,93,1340,95,858,92,860,3,3
3486,STJ2043,0,356,0,356,0,1,0,1,0,0
3487,STK2397,0,356,0,356,0,1,0,1,0,0
3488,STN2458,49,59,59,0,1,1,1,0,10,59
3489,STR1769,102,1334,453,983,99,865,95,867,351,351
3490,STR3896,0,356,0,356,0,1,0,1,0,0
3491,SUG0718,0,356,0,356,0,1,0,1,0,0
3492,SVA1742,0,356,0,356,0,1,0,1,0,0
3493,SVM0077,0,356,356,0,0,1,1,0,356,356
3494,SVM0770,0,356,356,0,0,1,1,0,356,356
3495,SVM3947,0,355,193,163,0,1,1,1,193,192
3496,SWA1824,334,381,67,380,60,25,60,25,267,1
3497,SWE1349,0,356,356,0,0,1,1,0,356,356
3498,SWE3155,266,356,180,176,1,1,1,1,86,180
3499,SWG1391,0,356,0,356,0,1,0,1,0,0
3500,SWG2200,0,356,356,0,0,1,1,0,356,356
3501,SWH1053,96,1324,88,1332,93,844,85,851,8,8
3502,SWK1436,0,356,0,356,0,1,0,1,0,0
3503,SWM0188,21,356,220,157,21,1,22,1,199,199
3504,SWO3258,1,412,356,57,1,1,1,1,355,355
3505,SWR3808,0,356,0,356,0,1,0,1,0,0
3506,SWS0823,0,356,0,356,0,1,0,1,0,0
3507,SXO3514,277,356,188,168,1,1,1,1,89,188
3508,SXR0964,0,356,356,0,0,1,1,0,356,356
3509,SXW0537,3,353,356,0,1,1,1,0,353,353
3510,SYF1650,0,356,0,356,0,1,0,1,0,0
3511,SYF3607,0,399,357,42,0,1,1,1,357,357
3512,SYM2379,0,356,0,356,0,1,0,1,0,0
3513,SZB0321,0,356,356,0,0,1,1,0,356,356
3514,SZC2235,0,177,177,0,0,1,1,0,177,177
3515,SZG0325,191,165,0,356,1,1,0,1,191,191
3516,TAB0684,342,412,424,55,60,33,62,31,82,357
3517,TAB1870,346,376,432,13,64,19,69,13,86,363
3518,TAB3539,40,371,398,13,39,16,42,13,358,358
3519,TAC3330,0,356,0,356,0,1,0,1,0,0
3520,TAC3425,0,356,61,295,0,1,1,1,61,61
3521,TAD1414,0,356,16,340,0,1,1,1,16,16
3522,TAE1559,283,356,0,356,1,1,0,1,283,0
3523,TAF0640,356,0,9,347,1,0,1,1,347,347
3524,TAH0933,0,356,356,0,0,1,1,0,356,356
3525,TAJ0193,355,397,76,398,71,40,68,40,279,1
3526,TAM1488,0,356,356,0,0,1,1,0,356,356
3527,TAM2031,10,346,356,0,1,1,1,0,346,346
3528,TAM3048,373,1883,96,1799,93,1124,92,1124,277,84
3529,TAN2642,0,281,155,126,0,1,1,1,155,155
3530,TAP0631,0,356,0,356,0,1,0,1,0,0
3531,TAP0664,293,423,189,208,1,1,1,1,104,215
3532,TAP1086,383,360,88,370,74,17,80,15,295,10
3533,TAW2664,288,389,366,33,11,28,11,28,78,356
3534,TBB1547,1,355,80,276,1,1,1,1,79,79
3535,TBC2256,380,384,109,379,88,29,93,23,271,5
3536,TBD2008,1,389,1,389,1,5,1,5,0,0
3537,TBK2860,0,356,195,161,0,1,1,1,195,195
3538,TBL2581,353,424,73,428,73,39,68,42,280,4
3539,TBM0932,0,356,356,0,0,1,1,0,356,356
3540,TBM3829,0,356,0,356,0,1,0,1,0,0
3541,TBS3382,184,172,0,356,1,1,0,1,184,184
3542,TBW1393,0,356,0,356,0,1,0,1,0,0
3543,TCB0061,387,379,471,9,88,22,100,9,84,370
3544,TCB0550,269,356,0,356,1,1,0,1,269,0
3545,TCG0016,270,356,0,356,1,1,0,1,270,0
3546,TCG1262,0,356,6,350,0,1,1,1,6,6
3547,TCH2216,297,364,17,361,18,6,17,6,280,3
3548,TCH2233,0,356,356,0,0,1,1,0,356,356
3549,TCM2403,495,164,28,358,28,2,26,3,467,194
3550,TCN1687,6,384,6,384,6,29,6,29,0,0
3551,TCP2520,270,356,356,0,1,1,1,0,86,356
3552,TCR3994,0,356,0,356,0,1,0,1,0,0
3553,TDC3116,0,356,356,0,0,1,1,0,356,356
3554,TDG2727,0,356,0,356,0,1,0,1,0,0
3555,TDH0989,278,356,0,356,1,1,0,1,278,0
3556,TDJ3138,284,476,188,236,1,1,1,1,96,240
3557,TDK1689,385,630,93,535,86,58,84,58,292,95
3558,TDM2658,0,356,202,154,0,1,1,1,202,202
3559,TDM2859,0,356,191,165,0,1,1,1,191,191
3560,TDM3135,296,441,379,45,18,10,18,10,83,396
3561,TDR0111,50,66,0,66,1,1,0,1,50,0
3562,TDV1034,0,356,0,356,0,1,0,1,0,0
3563,TDV3188,377,381,466,19,91,24,95,19,89,362
3564,TDW1746,0,356,203,153,0,1,1,1,203,203
3565,TEC2300,144,193,193,0,1,1,1,0,49,193
3566,TEC3006,0,356,356,0,0,1,1,0,356,356
3567,TEF3555,0,356,0,356,0,1,0,1,0,0
3568,TEW0693,188,213,235,12,34,16,38,12,47,201
3569,TFB1229,0,356,0,356,0,1,0,1,0,0
3570,TFH0544,104,372,469,7,89,17,96,7,365,365
3571,TGA2006,0,356,0,356,0,1,0,1,0,0
3572,TGC1489,0,356,356,0,0,1,1,0,356,356
3573,TGH3351,386,687,96,577,88,57,84,60,290,110
3574,TGP1343,0,356,356,0,0,1,1,0,356,356
3575,TGW2782,0,356,0,356,0,1,0,1,0,0
3576,THB0987,487,206,14,403,16,7,14,8,473,197
3577,THC2752,274,356,0,356,1,1,0,1,274,0
3578,THF2879,72,410,13,470,16,7,13,9,59,60
3579,THG3271,0,356,0,356,0,1,0,1,0,0
3580,THH2751,313,434,37,437,38,35,34,38,276,3
3581,THM1021,0,356,356,0,0,1,1,0,356,356
3582,THM2665,0,356,356,0,0,1,1,0,356,356
3583,THR3371,0,356,0,356,0,1,0,1,0,0
3584,THW1425,0,356,0,356,0,1,0,1,0,0
3585,TIE1175,280,355,0,356,1,1,0,1,280,1
3586,TIJ1817,392,491,103,494,96,60,92,63,289,3
3587,TJB0540,374,357,447,1,82,5,85,1,73,356
3588,TJB2532,0,356,356,0,0,1,1,0,356,356
3589,TJB3240,264,356,0,356,1,1,0,1,264,0
3590,TJB3511,0,356,202,154,0,1,1,1,202,202
3591,TJD0106,327,588,398,133,36,13,37,13,71,455
3592,TJE1945,0,356,356,0,0,1,1,0,356,356
3593,TJL2113,0,356,356,0,0,1,1,0,356,356
3594,TJL3603,0,356,356,0,0,1,1,0,356,356
3595,TJM0328,0,356,0,356,0,1,0,1,0,0
3596,TJM3340,268,356,0,356,1,1,0,1,268,0
3597,TJP2817,75,379,80,374,67,23,71,19,5,5
3598,TJS3067,294,589,374,167,12,11,13,10,80,422
3599,TJT3412,0,356,2,354,0,1,1,1,2,2
3600,TKC0514,6,357,5,358,6,2,5,3,1,1
3601,TKD2115,0,356,356,0,0,1,1,0,356,356
3602,TKE3293,288,430,23,425,19,15,23,10,265,5
3603,TKK0628,17,413,14,416,16,7,13,9,3,3
3604,TKM1539,344,614,68,509,56,34,58,32,276,105
3605,TKM2494,26,329,0,356,1,1,0,1,26,27
3606,TKN0812,0,178,0,178,0,1,0,1,0,0
3607,TKO0417,0,356,0,356,0,1,0,1,0,0
3608,TKP0210,358,445,68,423,66,21,61,27,290,22
3609,TKS1549,299,391,61,344,14,2,13,3,238,47
3610,TKS3035,385,521,475,97,94,39,99,32,90,424
3611,TLC1147,0,356,356,0,0,1,1,0,356,356
3612,TLK0003,287,452,3,452,4,30,3,30,284,0
3613,TLP1231,281,356,0,356,1,1,0,1,281,0
3614,TLU1836,0,356,0,356,0,1,0,1,0,0
3615,TLW2668,0,356,356,0,0,1,1,0,356,356
3616,TMB1474,278,355,356,0,1,1,1,0,78,355
3617,TMC3659,378,484,93,468,87,77,80,80,285,16
3618,TMV0868,353,375,449,8,76,15,87,4,96,367
3619,TND0324,191,165,0,356,1,1,0,1,191,191
3620,TNH3028,64,85,85,0,1,1,1,0,21,85
3621,TNR0319,468,159,0,356,1,1,0,1,468,197
3622,TNS1233,0,356,0,356,0,1,0,1,0,0
3623,TNV3213,26,366,383,9,25,11,27,9,357,357
3624,TOS3712,0,356,0,356,0,1,0,1,0,0
3625,TPF1663,0,356,0,356,0,1,0,1,0,0
3626,TPG2392,0,356,356,0,0,1,1,0,356,356
3627,TPM0039,0,356,0,356,0,1,0,1,0,0
3628,TPM0234,0,79,79,0,0,1,1,0,79,79
3629,TPM3141,0,356,184,172,0,1,1,1,184,184
3630,TPS1568,327,550,51,489,50,46,47,46,276,61
3631,TPS2595,272,356,0,356,1,1,0,1,272,0
3632,TQR3104,0,356,356,0,0,1,1,0,356,356
3633,TRC1831,0,356,0,356,0,1,0,1,0,0
3634,TRH1083,322,483,30,434,30,12,30,11,292,49
3635,TRS3323,285,356,0,356,1,1,0,1,285,0
3636,TRV2966,279,356,356,0,1,1,1,0,77,356
3637,TRW3172,4,352,53,303,1,1,1,1,49,49
3638,TSD2948,555,249,78,446,77,17,74,19,477,197
3639,TSF3478,0,356,356,0,0,1,1,0,356,356
3640,TSH3841,0,356,0,356,0,1,0,1,0,0
3641,TSL2699,1,355,356,0,1,1,1,0,355,355
3642,TSO3216,64,400,66,398,58,29,60,27,2,2
3643,TSS3643,0,356,0,356,0,1,0,1,0,0
3644,TTB0471,356,0,0,356,1,0,0,1,356,356
3645,TTD2873,0,356,179,177,0,1,1,1,179,179
3646,TTF2920,281,376,193,195,13,21,11,23,88,181
3647,TTK2633,0,356,187,169,0,1,1,1,187,187
3648,TTL3088,276,375,181,198,7,6,8,5,95,177
3649,TTP2417,0,356,356,0,0,1,1,0,356,356
3650,TTR0045,84,1326,82,1328,81,862,79,864,2,2
3651,TVC2918,287,384,202,194,12,10,10,12,85,190
3652,TVS0520,25,394,23,396,25,39,23,41,2,2
3653,TWF1072,0,356,0,356,0,1,0,1,0,0
3654,TWH1178,0,356,0,356,0,1,0,1,0,0
3655,TWK1773,87,1335,441,981,86,849,85,850,354,354
3656,TWM0837,191,165,0,356,1,1,0,1,191,191
3657,TWM2199,12,490,376,126,12,7,14,6,364,364
3658,TWW0811,277,356,1,355,1,1,1,1,276,1
3659,TZG2263,0,356,0,356,0,1,0,1,0,0
3660,TZM0239,0,356,356,0,0,1,1,0,356,356
3661,TZM0716,0,356,0,356,0,1,0,1,0,0
3662,TZM0851,491,178,14,365,16,9,14,10,477,187
3663,TZY3133,68,134,90,29,6,7,6,7,22,105
3664,UAD2700,0,142,142,0,0,1,1,0,142,142
3665,UAH3940,0,356,192,164,0,1,1,1,192,192
3666,UAS2829,0,356,182,174,0,1,1,1,182,182
3667,UCG0322,0,356,356,0,0,1,1,0,356,356
3668,UCM3537,277,358,356,0,1,1,1,0,79,358
3669,UCS3454,275,356,0,356,1,1,0,1,275,0
3670,UCW2995,287,575,372,122,14,11,16,8,85,453
3671,UDB1170,355,406,88,397,82,37,81,34,267,9
3672,UDW0487,0,356,356,0,0,1,1,0,356,356
3673,UEP2013,0,356,0,356,0,1,0,1,0,0
3674,UIM2818,0,356,0,356,0,1,0,1,0,0
3675,UKC0543,302,336,356,0,1,1,1,0,54,336
3676,UKC1192,263,356,356,0,1,1,1,0,93,356
3677,UKS1465,98,371,464,5,91,16,99,5,366,366
3678,ULP1169,0,356,0,356,0,1,0,1,0,0
3679,UMB0055,403,161,44,521,47,36,44,38,359,360
3680,UME2842,0,356,190,166,0,1,1,1,190,190
3681,UMF2894,386,297,21,378,22,3,21,4,365,81
3682,UMH1532,0,356,356,0,0,1,1,0,356,356
3683,UMH3826,0,356,0,356,0,1,0,1,0,0
3684,UMM3017,0,356,0,356,0,1,0,1,0,0
3685,UMS0883,361,380,98,379,89,25,89,24,263,1
3686,UNB3986,0,310,0,310,0,1,0,1,0,0
3687,UOM3363,343,371,71,371,66,16,65,15,272,0
3688,URC2874,401,531,116,470,105,36,105,35,285,61
3689,URC3818,81,373,81,373,68,18,68,18,0,0
3690,USC3486,0,356,0,356,0,1,0,1,0,0
3691,USD0600,0,356,0,356,0,1,0,1,0,0
3692,USF1753,0,356,192,164,0,1,1,1,192,192
3693,UVN0903,0,356,0,356,0,1,0,1,0,0
3694,UWB0395,0,356,356,0,0,1,1,0,356,356
3695,UXC1495,371,436,465,69,94,22,104,12,94,367
3696,UYW1162,0,356,0,356,0,1,0,1,0,0
3697,VAB1102,0,356,356,0,0,1,1,0,356,356
3698,VAB1526,0,432,356,76,0,1,1,1,356,356
3699,VAC3966,282,407,0,384,1,1,0,1,282,23
3700,VAD2639,0,440,180,260,0,1,1,1,180,180
3701,VAR3559,0,356,356,0,0,1,1,0,356,356
3702,VAS3984,0,307,0,307,0,1,0,1,0,0
3703,VBA1395,0,356,0,356,0,1,0,1,0,0
3704,VBN0984,20,403,377,46,20,3,22,2,357,357
3705,VBP1871,1,361,357,5,1,6,2,5,356,356
3706,VCF3273,292,611,19,501,16,20,18,16,273,110
3707,VCH3696,299,397,378,40,21,2,22,1,79,357
3708,VCR3103,0,356,356,0,0,1,1,0,356,356
3709,VCS1196,0,356,356,0,0,1,1,0,356,356
3710,VCV1353,0,356,356,0,0,1,1,0,356,356
3711,VCV2521,373,374,471,8,95,19,104,8,98,366
3712,VDB0247,3,353,0,356,1,1,0,1,3,3
3713,VDH0766,192,164,0,356,1,1,0,1,192,192
3714,VDI1217,0,126,0,126,0,1,0,1,0,0
3715,VDM2701,0,270,270,0,0,1,1,0,270,270
3716,VDP0790,0,356,0,356,0,1,0,1,0,0
3717,VEB3671,16,462,16,462,16,26,16,26,0,0
3718,VEC1686,0,356,0,356,0,1,0,1,0,0
3719,VEW0278,0,251,0,251,0,1,0,1,0,0
3720,VFM3223,328,381,50,379,44,27,46,23,278,2
3721,VGM2096,0,356,0,356,0,1,0,1,0,0
3722,VHG3993,364,364,92,363,84,10,84,8,272,1
3723,VHH0485,0,356,356,0,0,1,1,0,356,356
3724,VHM2280,0,355,0,356,0,1,0,1,0,1
3725,VIB2070,282,356,0,356,1,1,0,1,282,0
3726,VJB1699,281,356,0,356,1,1,0,1,281,0
3727,VJB1928,0,356,356,0,0,1,1,0,356,356
3728,VJC1974,14,342,0,356,1,1,0,1,14,14
3729,VJK1327,0,356,356,0,0,1,1,0,356,356
3730,VJM1336,0,356,356,0,0,1,1,0,356,356
3731,VJM2715,0,356,356,0,0,1,1,0,356,356
3732,VKA1118,360,393,83,396,80,37,75,39,277,3
3733,VKE0655,0,356,189,167,0,1,1,1,189,189
3734,VKM1515,63,370,420,13,56,14,58,12,357,357
3735,VKM2376,20,361,377,4,20,6,22,4,357,357
3736,VKM2949,205,243,15,433,16,2,15,2,190,190
3737,VKT2228,0,356,356,0,0,1,1,0,356,356
3738,VLF1113,0,412,0,412,0,1,0,1,0,0
3739,VLM3572,279,356,356,0,1,1,1,0,77,356
3740,VMJ3068,0,356,356,0,0,1,1,0,356,356
3741,VMN0743,298,367,377,7,20,10,21,7,79,360
3742,VMW1500,0,356,356,0,0,1,1,0,356,356
3743,VNC1607,0,356,356,0,0,1,1,0,356,356
3744,VND1667,0,356,0,356,0,1,0,1,0,0
3745,VNG0916,360,456,278,251,77,13,78,12,82,205
3746,VNH1282,0,328,191,137,0,1,1,1,191,191
3747,VON3443,0,356,0,356,0,1,0,1,0,0
3748,VPG2530,362,376,438,10,68,21,76,10,76,366
3749,VPS3185,302,479,69,375,16,4,15,5,233,104
3750,VQS3246,285,356,0,356,1,1,0,1,285,0
3751,VRB3401,195,161,0,356,1,1,0,1,195,195
3752,VRJ0636,727,3,105,364,98,3,92,9,622,361
3753,VSC0775,23,460,383,100,23,37,28,33,360,360
3754,VSF0004,0,356,356,0,0,1,1,0,356,356
3755,VSJ2569,0,174,0,174,0,1,0,1,0,0
3756,VTB0576,0,356,0,356,0,1,0,1,0,0
3757,VTB2147,0,356,356,0,0,1,1,0,356,356
3758,VTD1184,0,356,356,0,0,1,1,0,356,356
3759,VTD2731,0,356,0,356,0,1,0,1,0,0
3760,VTK2978,278,417,356,61,1,1,1,1,78,356
3761,VTL0314,370,408,92,407,80,51,79,52,278,1
3762,VWB0990,278,356,0,356,1,1,0,1,278,0
3763,VWV1249,0,356,0,356,0,1,0,1,0,0
3764,VYP0637,235,4,4,235,7,4,4,7,231,231
3765,VZG2484,356,0,1,355,1,0,1,1,355,355
3766,WAA1816,274,356,0,356,1,1,0,1,274,0
3767,WAA2573,54,74,0,74,1,1,0,1,54,0
3768,WAC3677,285,356,0,356,1,1,0,1,285,0
3769,WAF3438,377,491,135,392,74,27,76,24,242,99
3770,WAH2778,269,379,0,370,1,1,0,1,269,9
3771,WAH3836,0,356,356,0,0,1,1,0,356,356
3772,WAJ2412,273,357,356,0,1,1,1,0,83,357
3773,WAL0050,378,1370,100,1373,99,886,95,888,278,3
3774,WAM0069,0,356,356,0,0,1,1,0,356,356
3775,WAR1374,0,356,356,0,0,1,1,0,356,356
3776,WAS2214,0,413,0,413,0,6,0,6,0,0
3777,WAW0422,0,356,356,0,0,1,1,0,356,356
3778,WBA1786,0,356,0,356,0,1,0,1,0,0
3779,WBB2321,325,564,52,483,49,26,49,25,273,81
3780,WBC1203,388,371,476,3,90,16,99,3,88,368
3781,WBE0967,0,356,356,0,0,1,1,0,356,356
3782,WBH1861,382,632,471,171,88,62,93,54,89,461
3783,WBL2852,273,356,199,157,1,1,1,1,74,199
3784,WBM0690,0,356,356,0,0,1,1,0,356,356
3785,WBM1045,79,1314,72,1321,79,853,72,857,7,7
3786,WBS1592,0,355,356,0,0,1,1,0,356,355
3787,WBS3870,384,386,459,22,83,30,89,21,75,364
3788,WCB0801,0,356,0,356,0,1,0,1,0,0
3789,WCM3134,0,356,356,0,0,1,1,0,356,356
3790,WCP2123,0,356,356,0,0,1,1,0,356,356
3791,WCR2136,6,30,36,0,6,1,7,0,30,30
3792,WDD0499,0,356,0,356,0,1,0,1,0,0
3793,WDD2677,43,363,400,6,41,7,43,5,357,357
3794,WDH0910,0,356,199,157,0,1,1,1,199,199
3795,WDL0140,0,356,0,356,0,1,0,1,0,0
3796,WDS2197,366,372,442,11,74,16,77,11,76,361
3797,WEB3897,0,356,0,356,0,1,0,1,0,0
3798,WEC3721,0,356,0,356,0,1,0,1,0,0
3799,WES2531,0,356,356,0,0,1,1,0,356,356
3800,WET2108,0,356,0,356,0,1,0,1,0,0
3801,WEV2867,355,366,278,167,72,11,78,6,77,199
3802,WFH2830,277,357,189,167,1,1,1,1,88,190
3803,WFN0926,0,356,186,170,0,1,1,1,186,186
3804,WGC1081,0,356,0,356,0,1,0,1,0,0
3805,WGD3156,277,356,186,170,1,1,1,1,91,186
3806,WGF0506,0,356,0,356,0,1,0,1,0,0
3807,WGM1823,0,356,0,356,0,1,0,1,0,0
3808,WHH2938,180,176,0,356,1,1,0,1,180,180
3809,WHL3282,0,356,0,356,0,1,0,1,0,0
3810,WHW2777,0,243,0,243,0,1,0,1,0,0
3811,WIB3670,0,356,0,356,0,1,0,1,0,0
3812,WJC0470,356,0,0,356,1,0,0,1,356,356
3813,WJC2637,0,390,187,203,0,1,1,1,187,187
3814,WJH0717,0,356,0,356,0,1,0,1,0,0
3815,WJH3158,0,277,148,129,0,1,1,1,148,148
3816,WJM3209,278,379,368,5,11,8,13,5,90,374
3817,WJR3544,4,352,1,355,1,1,1,1,3,3
3818,WJW3627,270,356,356,0,1,1,1,0,86,356
3819,WKC0573,312,375,42,374,39,19,40,18,270,1
3820,WKF3444,0,356,0,356,0,1,0,1,0,0
3821,WKG0150,698,4,59,364,61,4,57,9,639,360
3822,WKH1787,0,356,0,356,0,1,0,1,0,0
3823,WKS3265,78,370,443,5,73,15,82,5,365,365
3824,WKT0099,296,349,356,0,1,1,1,0,60,349
3825,WLC0115,0,356,356,0,0,1,1,0,356,356
3826,WLG0406,321,293,356,0,1,1,1,0,35,293
3827,WLL1133,0,356,356,0,0,1,1,0,356,356
3828,WLR0707,0,260,260,0,0,1,1,0,260,260
3829,WMA2016,285,397,0,380,1,1,0,1,285,17
3830,WMM0873,26,38,5,36,7,3,5,4,21,2
3831,WMM3904,0,356,0,356,0,1,0,1,0,0
3832,WMR2625,0,356,178,178,0,1,1,1,178,178
3833,WMR2685,285,425,0,400,1,1,0,1,285,25
3834,WMR2723,364,412,445,33,72,26,78,19,81,379
3835,WNC0858,0,356,356,0,0,1,1,0,356,356
3836,WNC0874,0,162,0,162,0,1,0,1,0,0
3837,WNO1466,100,448,467,81,91,24,101,15,367,367
3838,WNR0091,643,0,0,356,1,0,0,1,643,356
3839,WNR0661,0,356,192,164,0,1,1,1,192,192
3840,WNW2002,0,356,0,356,0,1,0,1,0,0
3841,WOL3226,357,393,80,396,74,35,69,39,277,3
3842,WOV3040,322,1170,82,1174,87,737,82,741,240,4
3843,WPJ1400,0,48,0,48,0,1,0,1,0,0
3844,WPR1884,0,356,356,0,0,1,1,0,356,356
3845,WRF3534,1,444,361,84,1,4,2,4,360,360
3846,WRJ2184,294,394,375,35,17,39,20,35,81,359
3847,WRM0515,368,375,103,371,90,20,92,16,265,4
3848,WRM2803,381,403,97,403,84,47,85,48,284,0
3849,WRW2331,339,586,85,506,65,38,68,34,254,80
3850,WSA1765,97,1335,450,982,90,864,88,866,353,353
3851,WSB1368,0,356,0,356,0,1,0,1,0,0
3852,WSC2981,0,356,356,0,0,1,1,0,356,356
3853,WSE1949,269,366,0,356,1,1,0,1,269,10
3854,WSH1130,0,356,356,0,0,1,1,0,356,356
3855,WSM2798,0,356,0,356,0,1,0,1,0,0
3856,WSS0820,278,381,2,379,1,1,1,1,276,2
3857,WTF0449,0,356,0,356,0,1,0,1,0,0
3858,WTG2109,346,386,63,392,67,29,61,35,283,6
3859,WTG3411,0,356,0,356,0,1,0,1,0,0
3860,WUH2238,0,356,356,0,0,1,1,0,356,356
3861,WVC3623,44,425,409,60,43,27,48,23,365,365
3862,WVD0570,0,356,0,356,0,1,0,1,0,0
3863,WVM1669,0,356,0,356,0,1,0,1,0,0
3864,WWS0645,0,356,193,163,0,1,1,1,193,193
3865,WXH2289,0,356,356,0,0,1,1,0,356,356
3866,WXM3698,0,356,356,0,0,1,1,0,356,356
3867,WYC2416,0,356,356,0,0,1,1,0,356,356
3868,WYC3397,184,172,0,356,1,1,0,1,184,184
3869,WZG3563,365,380,456,19,85,25,88,19,91,361
3870,WZR3948,14,357,202,169,14,2,15,2,188,188
3871,XAB0627,281,356,0,356,1,1,0,1,281,0
3872,XAB0936,133,163,169,1,8,3,9,1,36,162
3873,XAB3746,32,363,28,367,31,8,28,12,4,4
3874,XAH2479,356,0,0,356,1,0,0,1,356,356
3875,XAL0414,405,360,469,1,97,6,99,1,64,359
3876,XAL2816,296,358,20,357,20,3,20,2,276,1
3877,XAR1011,0,356,0,356,0,1,0,1,0,0
3878,XBH0357,0,356,0,356,0,1,0,1,0,0
3879,XBK2623,356,0,0,356,1,0,0,1,356,356
3880,XBL3922,0,356,356,0,0,1,1,0,356,356
3881,XBW2502,373,691,84,587,76,71,74,73,289,104
3882,XCB1390,0,356,0,356,0,1,0,1,0,0
3883,XCG2316,0,225,0,225,0,1,0,1,0,0
3884,XCJ0023,0,356,356,0,0,1,1,0,356,356
3885,XCL1792,46,442,48,440,42,21,45,19,2,2
3886,XEJ0773,0,356,356,0,0,1,1,0,356,356
3887,XFF1302,2,308,129,181,2,2,3,2,127,127
3888,XFL1583,0,183,0,183,0,1,0,1,0,0
3889,XGB1528,268,356,356,0,1,1,1,0,88,356
3890,XHR2377,676,15,33,377,38,2,31,8,643,362
3891,XIW0171,26,367,221,172,26,12,30,9,195,195
3892,XIW2655,298,361,205,170,15,6,16,5,93,191
3893,XJB0548,0,356,0,356,0,1,0,1,0,0
3894,XJM3874,343,369,426,10,59,14,62,10,83,359
3895,XKL1317,0,356,184,172,0,1,1,1,184,184
3896,XKR2059,0,356,0,356,0,1,0,1,0,0
3897,XKW1135,332,367,425,4,60,12,67,4,93,363
3898,XKW2303,0,356,356,0,0,1,1,0,356,356
3899,XML3920,0,356,356,0,0,1,1,0,356,356
3900,XPW2833,278,432,182,250,1,1,1,1,96,182
3901,XRP3102,0,356,356,0,0,1,1,0,356,356
3902,XSF3982,4,356,10,350,4,1,4,2,6,6
3903,XSR3526,0,356,356,0,0,1,1,0,356,356
3904,XTB2372,16,440,15,441,15,20,14,21,1,1
3905,XTB3322,0,301,0,301,0,1,0,1,0,0
3906,XUC1092,2,354,0,356,1,1,0,1,2,2
3907,XWM0415,305,321,356,0,1,1,1,0,51,321
3908,YAS2508,0,356,356,0,0,1,1,0,356,356
3909,YAV0093,288,358,368,0,11,3,13,0,80,358
3910,YBJ0071,2,354,0,356,1,1,0,1,2,2
3911,YBP3978,0,356,0,356,0,1,0,1,0,0
3912,YCA2885,31,325,0,356,1,1,0,1,31,31
3913,YCL0650,81,371,265,187,69,15,73,12,184,184
3914,YCL0824,386,628,92,537,84,52,84,51,294,91
3915,YCL2166,0,356,356,0,0,1,1,0,356,356
3916,YDE3069,0,356,356,0,0,1,1,0,356,356
3917,YDM1720,653,0,42,323,10,0,9,2,611,323
3918,YDM2537,0,342,0,342,0,1,0,1,0,0
3919,YDM3898,308,449,30,413,29,13,30,11,278,36
3920,YFP2558,0,356,0,356,0,1,0,1,0,0
3921,YFT1382,370,380,453,15,82,25,89,15,83,365
3922,YHB2355,347,383,67,382,61,26,62,25,280,1
3923,YHD0593,0,348,0,348,0,1,0,1,0,0
3924,YHH2785,0,356,0,356,0,1,0,1,0,0
3925,YIP1802,0,35,35,0,0,1,1,0,35,35
3926,YJD3130,0,356,356,0,0,1,1,0,356,356
3927,YJP2689,280,370,1,367,2,12,1,12,279,3
3928,YJP2791,0,356,0,356,0,1,0,1,0,0
3929,YJR1149,34,46,46,0,1,1,1,0,12,46
3930,YKM2435,102,1349,291,1160,99,892,96,896,189,189
3931,YKM3542,374,478,101,436,84,34,91,28,273,42
3932,YKW1763,101,1337,452,986,100,869,96,873,351,351
3933,YKW3832,7,612,6,613,7,13,6,14,1,1
3934,YLL0795,274,356,0,356,1,1,0,1,274,0
3935,YMB2953,494,159,20,359,21,3,19,4,474,200
3936,YNR2544,0,161,0,161,0,1,0,1,0,0
3937,YNW2855,360,566,277,316,80,34,81,32,83,250
3938,YOH1176,106,131,0,131,1,1,0,1,106,0
3939,YQB2309,0,325,325,0,0,1,1,0,325,325
3940,YRA3503,0,356,0,356,0,1,0,1,0,0
3941,YRW0842,191,259,0,450,1,1,0,1,191,191
3942,YSC1691,0,356,0,356,0,1,0,1,0,0
3943,YSG1195,0,356,356,0,0,1,1,0,356,356
3944,YSH0145,0,356,187,169,0,1,1,1,187,187
3945,YYD3518,0,145,72,73,0,1,1,1,72,72
3946,YZC3244,285,356,0,356,1,1,0,1,285,0
3947,ZAC1838,0,356,0,356,0,1,0,1,0,0
3948,ZAF3065,0,356,356,0,0,1,1,0,356,356
3949,ZAN1931,0,356,356,0,0,1,1,0,356,356
3950,ZAP1762,376,1339,458,984,102,867,101,867,82,355
3951,ZAR0404,0,495,0,495,0,1,0,1,0,0
3952,ZAR2140,0,356,356,0,0,1,1,0,356,356
3953,ZAW2012,0,356,0,356,0,1,0,1,0,0
3954,ZAW3833,0,356,356,0,0,1,1,0,356,356
3955,ZBH3422,273,354,88,268,1,1,1,1,185,86
3956,ZBW0132,0,356,356,0,0,1,1,0,356,356
3957,ZBW1015,476,158,0,356,1,1,0,1,476,198
3958,ZCE3578,0,405,0,405,0,1,0,1,0,0
3959,ZCM1781,0,132,0,132,0,1,0,1,0,0
3960,ZCR0558,379,435,463,74,89,24,92,18,84,361
3961,ZCS0012,0,356,0,356,0,1,0,1,0,0
3962,ZCT1009,0,356,0,356,0,1,0,1,0,0
3963,ZDC2523,293,681,364,226,1,1,1,1,71,455
3964,ZDC3269,0,401,356,45,0,1,1,1,356,356
3965,ZDH2905,0,356,199,157,0,1,1,1,199,199
3966,ZER0085,0,356,0,356,0,1,0,1,0,0
3967,ZGP2957,204,181,20,365,21,9,20,10,184,184
3968,ZHB1392,0,356,0,356,0,1,0,1,0,0
3969,ZHF1006,2,357,203,156,2,2,4,1,201,201
3970,ZHH3206,0,356,356,0,0,1,1,0,356,356
3971,ZHM1979,356,0,0,356,1,0,0,1,356,356
3972,ZHT3869,0,356,356,0,0,1,1,0,356,356
3973,ZIR1732,0,356,356,0,0,1,1,0,356,356
3974,ZJA2373,37,319,0,356,1,1,0,1,37,37
3975,ZJB0552,0,356,0,356,0,1,0,1,0,0
3976,ZJS1776,433,1357,514,1000,146,884,146,881,81,357
3977,ZJS2648,86,153,56,94,6,2,7,1,30,59
3978,ZKR1397,0,356,0,356,0,1,0,1,0,0
3979,ZLB1878,0,356,356,0,0,1,1,0,356,356
3980,ZLG3090,0,236,124,112,0,1,1,1,124,124
3981,ZMB3686,0,356,356,0,0,1,1,0,356,356
3982,ZMB3863,0,356,356,0,0,1,1,0,356,356
3983,ZMH1543,0,356,3,353,0,1,1,1,3,3
3984,ZNA0921,0,356,199,157,0,1,1,1,199,199
3985,ZNB3313,30,369,35,364,29,13,34,9,5,5
3986,ZND2154,0,356,356,0,0,1,1,0,356,356
3987,ZNE3451,4,352,7,349,1,1,1,1,3,3
3988,ZNG3404,186,170,0,356,1,1,0,1,186,186
3989,ZOM0746,0,356,356,0,0,1,1,0,356,356
3990,ZOO1613,0,356,356,0,0,1,1,0,356,356
3991,ZRM0694,389,731,471,258,89,56,95,49,82,473
3992,ZSL2618,84,0,0,84,1,0,0,1,84,84
3993,ZSW2155,0,356,356,0,0,1,1,0,356,356
3994,ZTB2410,0,356,356,0,0,1,1,0,356,356
3995,ZVB2656,0,356,189,167,0,1,1,1,189,189
3996,ZVS1637,0,356,356,0,0,1,1,0,356,356
3997,ZWS3625,0,356,356,0,0,1,1,0,356,356
3998,ZXM3086,0,356,188,168,0,1,1,1,188,188
3999,ZZO2997,0,356,356,0,0,1,1,0,356,356
